Radnummer;Bokföringsdatum;Transaktionsdatum;Valutadatum;Transaktionstyp;Referens;Belopp;Bokfört saldo;;;;
1;2023-10-10;2023-10-10;;Överföring via internet;Möss dekoratione;-287,79;57 138,70;;;;
2;2023-10-10;2023-10-10;;Överföring via internet;Bocker till HÄS;-594,00;57 426,49;;;;
3;2023-10-10;2023-10-10;;Överföring via internet;Ramar till HÄS;-839,00;58 020,49;;;;
4;2023-10-10;2023-10-10;;Överföring via internet;Tygg;-185,30;58 859,49;;;;
5;2023-10-10;2023-10-10;;Överföring via internet;Libu nollningsev;-277,20;59 044,79;;;;
6;2023-10-10;2023-10-10;;Överföring via internet;Material libu;-781,90;59 321,99;;;;
7;2023-10-10;2023-10-10;;Överföring via internet;Intervjumat;-325,00;60 103,89;;;;
8;2023-10-10;2023-10-10;;Överföring via internet;Intervjumat;-75,00;60 428,89;;;;
9;2023-10-10;2023-10-10;;Överföring via internet;Bokföringsmat;-85,00;60 503,89;;;;
10;2023-10-10;2023-10-10;;Överföring via internet;Kaffe varvning;-231,70;60 588,89;;;;
11;2023-10-10;2023-10-10;;Överföring via internet;Bokföringsmat;-85,00;60 820,59;;;;
12;2023-10-10;2023-10-10;;Överföring via internet;Fogskum;-119,80;60 905,59;;;;
13;2023-10-10;2023-10-10;;Överföring via internet;Valle b skifte;-428,95;61 025,39;;;;
14;2023-10-10;2023-10-10;;Överföring via internet;Utskottsutbildni;-480,00;61 454,34;;;;
15;2023-10-10;2023-10-10;;Överföring via internet;Hjälmar;-507,00;61 934,34;;;;
16;2023-10-10;2023-10-10;;Överföring via internet;Ledningsskifte;-438,40;62 441,34;;;;
17;2023-10-10;2023-10-10;;Överföring via internet;ValleB tack;-280,00;62 879,74;;;;
18;2023-10-10;2023-10-10;;Överföring via internet;Bokföringsmat;-56,80;63 159,74;;;;
19;2023-10-10;2023-10-10;;Överföring via internet;Resa till punkte;-28,00;63 216,54;;;;
20;2023-10-10;2023-10-10;;Överföring via internet;Punktering;-400,00;63 244,54;;;;
21;2023-10-10;2023-10-10;;Överföring via internet;Oljefat + Däckme;-379,00;63 644,54;;;;
22;2023-10-09;2023-10-09;2023-10-10;Bankgiro inbetalning;6428437;300,00;64 023,54;;;;
23;2023-10-09;2023-10-09;2023-10-09;Överföring via internet;Blombukett;-149,00;63 723,54;;;;
24;2023-10-09;2023-10-08;2023-10-08;Bg-bet. via internet;Stortorg Bil;-2 190,00;63 872,54;;;;
25;2023-10-09;2023-10-07;2023-10-07;Bg-bet. via internet;Engångsartiklar;-2 067,00;66 062,54;;;;
26;2023-10-09;2023-10-07;2023-10-07;Bg-bet. via internet;Nya Skåp;-43 775,00;68 129,54;;;;
27;2023-10-09;2023-10-07;2023-10-07;Bg-bet. via internet;Parkering Tour d;-79,00;111 904,54;;;;
28;2023-10-09;2023-10-07;2023-10-07;Bg-bet. via internet;Gasque Hyra WTF;-30 395,00;111 983,54;;;;
29;2023-10-09;2023-10-07;2023-10-07;Bg-bet. via internet;Försäkring Dröna;-1 400,00;142 378,54;;;;
30;2023-10-09;2023-10-07;2023-10-07;Pg-bet. via internet;Pingisnät;-678,00;143 778,54;;;;
31;2023-10-09;2023-10-07;2023-10-07;Pg-bet. via internet;Pingisbollar;-748,00;144 456,54;;;;
32;2023-10-06;2023-10-06;2023-10-09;Bankgiro inbetalning;6428437;1 764,00;145 204,54;;;;
33;2023-10-05;2023-10-05;2023-10-06;Bankgiro inbetalning;6428437;7 000,00;143 440,54;;;;
34;2023-10-03;2023-10-03;2023-10-03;Överföring via internet;Stortorg Glas;-59,80;136 440,54;;;;
35;2023-10-03;2023-10-03;2023-10-03;Överföring via internet;Stortorg Matpref;-19,90;136 500,34;;;;
36;2023-10-03;2023-10-03;2023-10-03;Överföring via internet;Stortorg Glas;-1 557,80;136 520,24;;;;
37;2023-10-03;2023-10-03;2023-10-03;Överföring via internet;Föset Outfit;-126,00;138 078,04;;;;
38;2023-10-03;2023-10-03;2023-10-03;Överföring via internet;Stortorg Mat;-171,92;138 204,04;;;;
39;2023-10-03;2023-10-03;2023-10-03;Överföring via internet;Stortorg Folie;-113,60;138 375,96;;;;
40;2023-10-03;2023-10-03;2023-10-03;Överföring via internet;Stortorg Städ;-49,80;138 489,56;;;;
41;2023-10-03;2023-10-03;2023-10-03;Överföring via internet;Uppdragskväll;-176,00;138 539,36;;;;
42;2023-10-03;2023-10-03;2023-10-03;Överföring via internet;Föset Outfit;-179,80;138 715,36;;;;
43;2023-10-03;2023-10-03;2023-10-03;Överföring via internet;Föset Outfit;-179,95;138 895,16;;;;
44;2023-10-03;2023-10-03;2023-10-03;Överföring via internet;Regattan Outfit;-330,00;139 075,11;;;;
45;2023-10-03;2023-10-03;2023-10-03;Överföring via internet;Stortorg Band;-139,70;139 405,11;;;;
46;2023-10-03;2023-10-03;2023-10-03;Överföring via internet;Föset Outfit;-408,00;139 544,81;;;;
47;2023-09-29;2023-09-29;2023-10-02;Bankgiro inbetalning;6428437;5 250,00;139 952,81;;;;
48;2023-09-29;2023-09-29;2023-09-29;Bg-bet. via internet;Wermlands;-21 220,00;134 702,81;;;;
49;2023-09-29;2023-09-29;2023-09-29;Bg-bet. via internet;Märken Nollesex;-2 056,00;155 922,81;;;;
50;2023-09-29;2023-09-29;2023-09-29;Överföring via internet;Faddergruppsmat;-466,55;157 978,81;;;;
51;2023-09-29;2023-09-29;2023-09-29;Överföring via internet;Campet lampa;-199,90;158 445,36;;;;
52;2023-09-29;2023-09-29;2023-09-29;Överföring via internet;Nollesex jobbarm;-2 470,00;158 645,26;;;;
53;2023-09-29;2023-09-29;2023-09-29;Överföring via internet;83139741326862;14 420,38;161 115,26;;;;
54;2023-09-29;2023-09-29;2023-09-29;Överföring via internet;Mötesfika;-162,90;146 694,88;;;;
55;2023-09-29;2023-09-29;2023-09-29;Överföring via internet;Nollesex komp;-332,00;146 857,78;;;;
56;2023-09-29;2023-09-29;2023-09-29;Överföring via internet;Nollympiaden;-264,70;147 189,78;;;;
57;2023-09-29;2023-09-29;2023-09-29;Överföring via internet;Nollesex komp;-235,90;147 454,48;;;;
58;2023-09-27;2023-09-27;2023-09-28;Bankgiro inbetalning;6428437;359,00;147 690,38;;;;
59;2023-09-25;2023-09-25;2023-09-26;Bankgiro inbetalning;6428437;80,00;147 331,38;;;;
60;2023-09-25;2023-09-25;2023-09-25;Bg-bet. via internet;Sponsring A sekt;-5 000,00;147 251,38;;;;
61;2023-09-25;2023-09-25;2023-09-25;Bg-bet. via internet;skadogörelse A s;-350,00;152 251,38;;;;
62;2023-09-25;2023-09-25;2023-09-25;Bg-bet. via internet;Merch inköp;-141,00;152 601,38;;;;
63;2023-09-25;2023-09-25;2023-09-25;Bg-bet. via internet;Aspia;-4 306,25;152 742,38;;;;
64;2023-09-25;2023-09-25;2023-09-25;Överföring via internet;HÄS Presentkort;-4 550,00;157 048,63;;;;
65;2023-09-21;2023-09-21;2023-09-21;Överföring via internet;83139741326862;-8 000,00;161 598,63;;;;
66;2023-09-19;2023-09-19;2023-09-20;Bankgiro inbetalning;6428437;275,00;169 598,63;;;;
67;2023-09-19;2023-09-19;2023-09-19;Överföring via internet;83139741326862;-15 000,00;169 323,63;;;;
68;2023-09-19;2023-09-19;2023-09-19;Överföring via internet;83139741326862;-30 000,00;184 323,63;;;;
69;2023-09-19;2023-09-19;2023-09-19;Överföring via internet;Faddergruppsmat;-775,00;214 323,63;;;;
70;2023-09-19;2023-09-19;2023-09-19;Överföring via internet;Internöverföring;200 000,00;215 098,63;;;;
71;2023-09-12;2023-09-12;2023-09-13;Bankgiro inbetalning;6428437;75,00;15 098,63;;;;
72;2023-09-12;2023-09-12;2023-09-12;Bg-bet. via internet;Mantelbrodyr;-3 413,00;15 023,63;;;;
73;2023-09-12;2023-09-12;2023-09-12;Bg-bet. via internet;FlyING bussar;-7 371,00;18 436,63;;;;
74;2023-09-12;2023-09-12;2023-09-12;Pg-bet. via internet;Sonnarp;-19 725,00;25 807,63;;;;
75;2023-09-11;2023-09-11;2023-09-12;Bankgiro inbetalning;6428437;20 325,00;45 532,63;;;;
76;2023-09-11;2023-09-11;2023-09-11;Bg-bet. via internet;Märken;-9 403,00;25 207,63;;;;
77;2023-09-11;2023-09-11;2023-09-11;Bg-bet. via internet;Hemsidaavgift;-485,00;34 610,63;;;;
78;2023-09-11;2023-09-11;2023-09-11;Pg-bet. via internet;Utefotboll;-1 800,00;35 095,63;;;;
79;2023-09-11;2023-09-11;2023-09-11;Pg-bet. via internet;Innefotboll;-1 800,00;36 895,63;;;;
80;2023-09-11;2023-09-11;2023-09-11;Överföring via internet;Milersättning;-1 325,00;38 695,63;;;;
81;2023-09-11;2023-09-11;2023-09-11;Överföring via internet;FlyING Tågresa;-87,75;40 020,63;;;;
82;2023-09-11;2023-09-11;2023-09-11;Överföring via internet;SING Jobbarmat;-125,00;40 108,38;;;;
83;2023-09-11;2023-09-11;2023-09-11;Överföring via internet;SING Komp-handli;-119,50;40 233,38;;;;
84;2023-09-11;2023-09-11;2023-09-11;Överföring via internet;Faddergruppsmat;-581,73;40 352,88;;;;
85;2023-09-11;2023-09-11;2023-09-11;Överföring via internet;Cykel hyra TDL;-1 800,00;40 934,61;;;;
86;2023-09-11;2023-09-11;2023-09-11;Överföring via internet;SING Komp-handli;-414,30;42 734,61;;;;
87;2023-09-11;2023-09-11;2023-09-11;Överföring via internet;Tour de lomma;-99,90;43 148,91;;;;
88;2023-09-11;2023-09-11;2023-09-11;Överföring via internet;Färg;-418,00;43 248,81;;;;
89;2023-09-11;2023-09-11;2023-09-11;Överföring via internet;SING Jobbarmat;-1 145,00;43 666,81;;;;
90;2023-09-11;2023-09-11;2023-09-11;Överföring via internet;Milersättning;-550,00;44 811,81;;;;
91;2023-09-11;2023-09-11;2023-09-11;Överföring via internet;Färg;-2 312,00;45 361,81;;;;
92;2023-09-11;2023-09-11;2023-09-11;Överföring via internet;Ovvelekar Grillk;-199,50;47 673,81;;;;
93;2023-09-11;2023-09-11;2023-09-11;Överföring via internet;Faddergruppsmat;-575,00;47 873,31;;;;
94;2023-09-11;2023-09-11;2023-09-11;Överföring via internet;SING Jobbarmat;-47,70;48 448,31;;;;
95;2023-09-11;2023-09-11;2023-09-11;Överföring via internet;Föset Outfit;-129,00;48 496,01;;;;
96;2023-09-11;2023-09-11;2023-09-11;Överföring via internet;Faddergruppsmat;-488,38;48 625,01;;;;
97;2023-09-08;2023-09-08;2023-09-11;Bankgiro inbetalning;6428437;1 000,00;49 113,39;;;;
98;2023-09-06;2023-09-06;2023-09-07;Bankgiro inbetalning;6428437;33 000,00;48 113,39;;;;
99;2023-09-06;2023-09-06;2023-09-06;Bg-bet. via internet;Halloween-märke;-2 540,00;15 113,39;;;;
100;2023-09-06;2023-09-06;2023-09-06;Överföring via internet;Planhyra;-450,00;17 653,39;;;;
101;2023-09-06;2023-09-06;2023-09-06;Överföring via internet;Valle B Tack;-620,00;18 103,39;;;;
102;2023-09-06;2023-09-06;2023-09-06;Överföring via internet;Skiftes buss;-438,40;18 723,39;;;;
103;2023-09-06;2023-09-06;2023-09-06;Överföring via internet;Arbetskläder;-248,00;19 161,79;;;;
104;2023-09-06;2023-09-06;2023-09-06;Överföring via internet;Milersättning;-1 325,00;19 409,79;;;;
105;2023-09-06;2023-09-06;2023-09-06;Överföring via internet;Mat;-211,50;20 734,79;;;;
106;2023-09-06;2023-09-06;2023-09-06;Överföring via internet;Styrelseutbildni;-680,00;20 946,29;;;;
107;2023-09-06;2023-09-06;2023-09-06;Överföring via internet;Skiftes buss;-175,50;21 626,29;;;;
108;2023-09-06;2023-09-06;2023-09-06;Överföring via internet;Diesel;-1 122,39;21 801,79;;;;
109;2023-09-06;2023-09-06;2023-09-06;Överföring via internet;Milersättning;-500,00;22 924,18;;;;
110;2023-09-06;2023-09-06;2023-09-06;Överföring via internet;Gyckel;-790,00;23 424,18;;;;
111;2023-09-05;2023-09-05;2023-09-06;Bankgiro inbetalning;6428437;740,00;24 214,18;;;;
112;2023-09-05;2023-09-05;2023-09-05;Överföring via internet;Inköp Inventarie;-1 824,30;23 474,18;;;;
113;2023-09-05;2023-09-05;2023-09-05;Överföring via internet;Skiftes buss;-438,40;25 298,48;;;;
114;2023-09-05;2023-09-05;2023-09-05;Överföring via internet;Tack Valleb;-650,00;25 736,88;;;;
115;2023-09-05;2023-09-05;2023-09-05;Överföring via internet;Skifte mat;-375,00;26 386,88;;;;
116;2023-09-05;2023-09-05;2023-09-05;Överföring via internet;Första hjälpen;-296,00;26 761,88;;;;
117;2023-09-05;2023-09-05;2023-09-05;Överföring via internet;Deisel;-1 168,37;27 057,88;;;;
118;2023-09-05;2023-09-05;2023-09-05;Överföring via internet;Skiftes buss;-438,00;28 226,25;;;;
119;2023-09-05;2023-09-05;2023-09-05;Överföring via internet;Skiftes buss;-438,40;28 664,25;;;;
120;2023-09-05;2023-09-05;2023-09-05;Överföring via internet;Inventarie;-1 595,00;29 102,65;;;;
121;2023-09-05;2023-09-05;2023-09-05;Överföring via internet;Byggmaterial Nol;-1 003,65;30 697,65;;;;
122;2023-09-05;2023-09-05;2023-09-05;Överföring via internet;Biltvätt;-69,28;31 701,30;;;;
123;2023-09-05;2023-09-05;2023-09-05;Överföring via internet;Biltvätt;-34,72;31 770,58;;;;
124;2023-09-05;2023-09-05;2023-09-05;Överföring via internet;Inköp Biltema;-274,50;31 805,30;;;;
125;2023-09-05;2023-09-05;2023-09-05;Överföring via internet;Skifte Middag;-3 319,00;32 079,80;;;;
126;2023-09-05;2023-09-05;2023-09-05;Överföring via internet;Rengöring;-99,90;35 398,80;;;;
127;2023-09-05;2023-09-05;2023-09-05;Överföring via internet;Skiftes buss;-438,40;35 498,70;;;;
128;2023-09-05;2023-09-05;2023-09-05;Överföring via internet;Nano Heltid;-500,00;35 937,10;;;;
129;2023-09-05;2023-09-05;2023-09-05;Överföring via internet;Byggmaterial;-807,40;36 437,10;;;;
130;2023-09-05;2023-09-05;2023-09-05;Överföring via internet;Skifte Fika;-249,20;37 244,50;;;;
131;2023-09-04;2023-09-03;2023-09-03;Överföring via internet;Faddergruppsmat;-700,00;37 493,70;;;;
132;2023-09-04;2023-09-03;2023-09-03;Överföring via internet;Camp Frukost;-27,80;38 193,70;;;;
133;2023-09-04;2023-09-03;2023-09-03;Överföring via internet;Camp Blandat;-374,40;38 221,50;;;;
134;2023-09-04;2023-09-03;2023-09-03;Överföring via internet;Faddergruppsmat;-515,24;38 595,90;;;;
135;2023-09-04;2023-09-03;2023-09-03;Överföring via internet;Faddergruppsmat;-434,04;39 111,14;;;;
136;2023-09-04;2023-09-03;2023-09-03;Överföring via internet;Camp Städning;-125,60;39 545,18;;;;
137;2023-09-04;2023-09-03;2023-09-03;Överföring via internet;Camp Jobbargodis;-141,00;39 670,78;;;;
138;2023-09-04;2023-09-03;2023-09-03;Överföring via internet;Camp Batterier;-134,80;39 811,78;;;;
139;2023-09-04;2023-09-03;2023-09-03;Överföring via internet;Marschaller;-497,30;39 946,58;;;;
140;2023-09-04;2023-09-03;2023-09-03;Överföring via internet;Ved;-899,10;40 443,88;;;;
141;2023-09-04;2023-09-03;2023-09-03;Överföring via internet;Faddergruppsmat;-504,00;41 342,98;;;;
142;2023-09-04;2023-09-03;2023-09-03;Överföring via internet;Faddergruppsmat;-548,04;41 846,98;;;;
143;2023-09-04;2023-09-03;2023-09-03;Överföring via internet;Faddergruppsmat;-85,60;42 395,02;;;;
144;2023-09-04;2023-09-03;2023-09-03;Överföring via internet;Material;-105,00;42 480,62;;;;
145;2023-09-04;2023-09-03;2023-09-03;Överföring via internet;Faddergruppsmat;-493,20;42 585,62;;;;
146;2023-09-04;2023-09-03;2023-09-03;Överföring via internet;Faddergruppsmat;-77,90;43 078,82;;;;
147;2023-09-04;2023-09-03;2023-09-03;Överföring via internet;Faddergruppsmat;-118,91;43 156,72;;;;
148;2023-09-04;2023-09-03;2023-09-03;Överföring via internet;Camp Drivmedel;-279,00;43 275,63;;;;
149;2023-08-31;2023-08-31;2023-08-30;Bg-bet. via internet;Busscampet;-43 245,00;43 554,63;;;;
150;2023-08-31;2023-08-31;2023-08-30;Bg-bet. via internet;Lednings Brodyr;-4 275,00;86 799,63;;;;
151;2023-08-31;2023-08-31;2023-08-30;Bg-bet. via internet;Brodyr;-1 893,75;91 074,63;;;;
152;2023-08-31;2023-08-31;2023-08-30;Bg-bet. via internet;Tryckerikostnade;-2 470,00;92 968,38;;;;
153;2023-08-31;2023-08-31;2023-08-30;Överföring via internet;Faddergruppsmat;-550,00;95 438,38;;;;
154;2023-08-31;2023-08-31;2023-08-30;Överföring via internet;Faddergruppsmat;-627,00;95 988,38;;;;
155;2023-08-30;2023-08-30;2023-09-01;Bankgiro inbetalning;6428437;150,00;96 615,38;;;;
156;2023-08-30;2023-08-30;2023-08-30;Bg-bet. via internet;Engångsartiklar;-5 846,00;96 465,38;;;;
157;2023-08-30;2023-08-30;2023-08-30;Överföring via internet;Campetmat;-179,00;102 311,38;;;;
158;2023-08-30;2023-08-30;2023-08-30;Överföring via internet;83139741326847;100 000,00;102 490,38;;;;
159;2023-08-30;2023-08-30;2023-08-30;Överföring via internet;Jobbarmat;-37,80;2 490,38;;;;
160;2023-08-30;2023-08-30;2023-08-30;Överföring via internet;Jobbarsnacks;-1 575,04;2 528,18;;;;
161;2023-08-30;2023-08-30;2023-08-30;Överföring via internet;Faddergruppsmat;-131,94;4 103,22;;;;
162;2023-08-30;2023-08-30;2023-08-30;Överföring via internet;Campetmat;-89,00;4 235,16;;;;
163;2023-08-30;2023-08-30;2023-08-30;Överföring via internet;Jobbargodis;-190,15;4 324,16;;;;
164;2023-08-30;2023-08-30;2023-08-30;Överföring via internet;Faddergruppsmat;-550,00;4 514,31;;;;
165;2023-08-30;2023-08-30;2023-08-30;Överföring via internet;Faddergruppsmat;-418,06;5 064,31;;;;
166;2023-08-30;2023-08-30;2023-08-30;Överföring via internet;Campetmat;-449,90;5 482,37;;;;
167;2023-08-29;2023-08-29;2023-08-29;Överföring via internet;Faddergruppsmat;-374,94;5 932,27;;;;
168;2023-08-29;2023-08-29;2023-08-29;Överföring via internet;83139741326862;-26 000,00;6 307,21;;;;
169;2023-08-28;2023-08-28;2023-08-28;Överföring via internet;Faddergruppsmat;-81,70;32 307,21;;;;
170;2023-08-28;2023-08-28;2023-08-28;Överföring via internet;Faddergruppsmat;-350,00;32 388,91;;;;
171;2023-08-28;2023-08-28;2023-08-28;Överföring via internet;Faddergruppsmat;-475,00;32 738,91;;;;
172;2023-08-28;2023-08-27;2023-08-27;Överföring via internet;83139741326862;-5 000,00;33 213,91;;;;
173;2023-08-23;2023-08-23;2023-08-23;Bg-bet. via internet;Domänkostnad;-120,00;38 213,91;;;;
174;2023-08-23;2023-08-23;2023-08-23;Bg-bet. via internet;Skumbollar;-931,86;38 333,91;;;;
175;2023-08-23;2023-08-23;2023-08-23;Bg-bet. via internet;Banhyra;-3 900,00;39 265,77;;;;
176;2023-08-23;2023-08-23;2023-08-23;Bg-bet. via internet;Banbetalning;-7 800,00;43 165,77;;;;
177;2023-08-23;2023-08-23;2023-08-23;Överföring via internet;Faddergruppsmat;-159,80;50 965,77;;;;
178;2023-08-23;2023-08-23;2023-08-23;Överföring via internet;Faddergruppsmat;-530,52;51 125,57;;;;
179;2023-08-23;2023-08-23;2023-08-23;Överföring via internet;Faddergruppsmat;-574,22;51 656,09;;;;
180;2023-08-23;2023-08-23;2023-08-23;Överföring via internet;Faddergruppsmat;-550,00;52 230,31;;;;
181;2023-08-23;2023-08-23;2023-08-23;Överföring via internet;Faddergruppsmat;-390,45;52 780,31;;;;
182;2023-08-23;2023-08-23;2023-08-23;Överföring via internet;Kol Utskottssafa;-211,60;53 170,76;;;;
183;2023-08-22;2023-08-22;2023-08-22;Överföring via internet;83139741326862;-45 000,00;53 382,36;;;;
184;2023-08-22;2023-08-22;2023-08-22;Överföring via internet;83139741326870;-10 000,00;98 382,36;;;;
185;2023-08-22;2023-08-22;2023-08-22;Överföring via internet;Faddergruppsmat;-550,00;108 382,36;;;;
186;2023-08-22;2023-08-22;2023-08-22;Överföring via internet;Internöverföring;100 000,00;108 932,36;;;;
187;2023-08-21;2023-08-20;2023-08-20;Bg-bet. via internet;Märken Nollning;-17 182,00;8 932,36;;;;
188;2023-08-21;2023-08-19;2023-08-19;Överföring via internet;Pompoms (tull);-467,00;26 114,36;;;;
189;2023-08-21;2023-08-19;2023-08-19;Överföring via internet;Outfit;-81,95;26 581,36;;;;
190;2023-08-21;2023-08-19;2023-08-19;Överföring via internet;Outfit;-240,75;26 663,31;;;;
191;2023-08-21;2023-08-19;2023-08-19;Överföring via internet;Outfit;-379,54;26 904,06;;;;
192;2023-08-21;2023-08-19;2023-08-19;Överföring via internet;Outfit;-188,60;27 283,60;;;;
193;2023-08-21;2023-08-19;2023-08-19;Överföring via internet;Adobe-konto;-2 328,30;27 472,20;;;;
194;2023-08-21;2023-08-19;2023-08-19;Överföring via internet;Outfit;-101,80;29 800,50;;;;
195;2023-08-21;2023-08-19;2023-08-19;Överföring via internet;Tyg;-66,00;29 902,30;;;;
196;2023-08-21;2023-08-19;2023-08-19;Överföring via internet;Mötesmat Föset;-85,00;29 968,30;;;;
197;2023-08-21;2023-08-19;2023-08-19;Överföring via internet;Outfit;-138,13;30 053,30;;;;
198;2023-08-21;2023-08-19;2023-08-19;Överföring via internet;Outfit;-19,00;30 191,43;;;;
199;2023-08-21;2023-08-19;2023-08-19;Överföring via internet;Outfit;-156,97;30 210,43;;;;
200;2023-08-21;2023-08-19;2023-08-19;Överföring via internet;Outfit;-118,00;30 367,40;;;;
201;2023-08-21;2023-08-19;2023-08-19;Överföring via internet;Outfit;-687,00;30 485,40;;;;
202;2023-08-21;2023-08-19;2023-08-19;Överföring via internet;Outfit;-122,20;31 172,40;;;;
203;2023-08-21;2023-08-19;2023-08-19;Överföring via internet;Outfit;-155,00;31 294,60;;;;
204;2023-08-21;2023-08-19;2023-08-19;Överföring via internet;Mötesmat Föset;-85,00;31 449,60;;;;
205;2023-08-21;2023-08-19;2023-08-19;Överföring via internet;Outfit;-248,08;31 534,60;;;;
206;2023-08-21;2023-08-19;2023-08-19;Överföring via internet;Outfit;-151,20;31 782,68;;;;
207;2023-08-21;2023-08-19;2023-08-19;Överföring via internet;Outfit;-61,20;31 933,88;;;;
208;2023-08-21;2023-08-19;2023-08-19;Överföring via internet;Outfit;-345,39;31 995,08;;;;
209;2023-08-21;2023-08-19;2023-08-19;Överföring via internet;Outfit;-59,38;32 340,47;;;;
210;2023-08-21;2023-08-19;2023-08-19;Överföring via internet;Outfit;-129,90;32 399,85;;;;
211;2023-08-18;2023-08-18;2023-08-21;Bankgiro inbetalning;6428437;4 500,00;32 529,75;;;;
212;2023-08-17;2023-08-16;2023-08-16;Överföring via internet;83139741326862;-5 000,00;28 029,75;;;;
213;2023-08-16;2023-08-16;2023-08-16;Överföring via internet;83139741326862;-22 000,00;33 029,75;;;;
214;2023-08-15;2023-08-15;2023-08-16;Bankgiro inbetalning;6428437;580,00;55 029,75;;;;
215;2023-08-14;2023-08-14;2023-08-15;Bankgiro inbetalning;6428437;400,00;54 449,75;;;;
216;2023-08-14;2023-08-13;2023-08-13;Överföring via internet;83139741326862;-210,00;54 049,75;;;;
217;2023-08-11;2023-08-11;2023-08-14;Bankgiro inbetalning;6428437;1 300,00;54 259,75;;;;
218;2023-08-11;2023-08-11;2023-08-11;Bg-bet. via internet;Bilförsäkring;-1 985,00;52 959,75;;;;
219;2023-08-11;2023-08-11;2023-08-11;Bg-bet. via internet;Datorryggsäkar F;-81 046,25;54 944,75;;;;
220;2023-08-11;2023-08-11;2023-08-11;Bg-bet. via internet;Drönarkörkortsko;-135,00;135 991,00;;;;
221;2023-08-11;2023-08-11;2023-08-11;Bg-bet. via internet;Fordonskatt;-1 671,00;136 126,00;;;;
222;2023-08-11;2023-08-11;2023-08-11;Överföring via internet;Bokföringsmat;-77,00;137 797,00;;;;
223;2023-08-11;2023-08-11;2023-08-11;Överföring via internet;Arbetskläder + A;-660,70;137 874,00;;;;
224;2023-08-10;2023-08-10;2023-08-11;Bankgiro inbetalning;6428437;1 000,00;138 534,70;;;;
225;2023-08-10;2023-08-10;2023-08-10;Bg-bet. via internet;Uteblivennärvaro;-400,00;137 534,70;;;;
226;2023-08-10;2023-08-10;2023-08-10;Bg-bet. via internet;Skvalborg Teknik;-1 590,00;137 934,70;;;;
227;2023-08-10;2023-08-10;2023-08-10;Bg-bet. via internet;Tandembiljetter;-44 550,00;139 524,70;;;;
228;2023-08-10;2023-08-10;2023-08-10;Bg-bet. via internet;Alumnipup;-2 705,00;184 074,70;;;;
229;2023-08-10;2023-08-10;2023-08-10;Bg-bet. via internet;Sångböcker;-31 630,00;186 779,70;;;;
230;2023-08-10;2023-08-10;2023-08-10;Överföring via internet;Revisormat;-84,70;218 409,70;;;;
231;2023-08-10;2023-08-10;2023-08-10;Överföring via internet;Revisormat;-170,00;218 494,40;;;;
232;2023-08-10;2023-08-10;2023-08-10;Överföring via internet;Heltidssittning;-2 000,00;218 664,40;;;;
233;2023-08-10;2023-08-10;2023-08-10;Överföring via internet;Ceq mat;-170,00;220 664,40;;;;
234;2023-08-10;2023-08-10;2023-08-10;Överföring via internet;Arbetskläder RM;-600,00;220 834,40;;;;
235;2023-08-09;2023-08-09;2023-08-09;Bg-bet. via internet;Lophtet Valborg;-2 915,00;221 434,40;;;;
236;2023-08-08;2023-08-08;2023-08-08;Överföring via internet;83139741326847;150 000,00;224 349,40;;;;
237;2023-07-03;2023-07-03;2023-07-03;Överföring via internet;83139741326862;-7 000,00;74 349,40;;;;
238;2023-06-30;2023-06-30;2023-06-30;Bg-bet. via internet;Mat FNU;-7 780,00;81 349,40;;;;
239;2023-06-30;2023-06-30;2023-06-30;Bg-bet. via internet;Ehuset tryckeri;-2 179,00;89 129,40;;;;
240;2023-06-30;2023-06-30;2023-06-30;Bg-bet. via internet;Fotoväg;-3 586,00;91 308,40;;;;
241;2023-06-30;2023-06-30;2023-06-30;Bg-bet. via internet;Paddel;-2 765,51;94 894,40;;;;
242;2023-06-22;2023-06-22;2023-06-26;Överföring;UF bidrag;38 400,00;97 659,91;;;;
243;2023-06-21;2023-06-21;2023-06-22;Bankgiro inbetalning;6428437;1 250,00;59 259,91;;;;
244;2023-06-16;2023-06-16;2023-06-16;Bg-bet. via internet;Reise skifte Lop;-1 250,00;58 009,91;;;;
245;2023-06-16;2023-06-16;2023-06-16;Pg-bet. via internet;Power Banks Tand;-1 159,80;59 259,91;;;;
246;2023-06-14;2023-06-14;2023-06-15;Bankgiro inbetalning;6428437;7 801,46;60 419,71;;;;
247;2023-06-09;2023-06-09;2023-06-09;Överföring via internet;Skor Fös-Outfit;-368,50;52 618,25;;;;
248;2023-06-09;2023-06-09;2023-06-09;Överföring via internet;Klänning Fös-Out;-984,50;52 986,75;;;;
249;2023-06-09;2023-06-09;2023-06-09;Överföring via internet;Glasögon Fös-Out;-894,00;53 971,25;;;;
250;2023-06-09;2023-06-09;2023-06-09;Överföring via internet;Skor Fös-Outfit;-283,00;54 865,25;;;;
251;2023-06-09;2023-06-09;2023-06-09;Överföring via internet;Skor till Fös-Ou;-348,00;55 148,25;;;;
252;2023-06-09;2023-06-09;2023-06-09;Överföring via internet;Ringar till Fös-;-22,00;55 496,25;;;;
253;2023-06-09;2023-06-09;2023-06-09;Överföring via internet;Tiara Fös-Outfit;-321,00;55 518,25;;;;
254;2023-06-09;2023-06-09;2023-06-09;Överföring via internet;Smycken Fös-Outf;-208,00;55 839,25;;;;
255;2023-06-09;2023-06-09;2023-06-09;Överföring via internet;Mötesmat Föset;-461,31;56 047,25;;;;
256;2023-06-09;2023-06-09;2023-06-09;Överföring via internet;Kjol Fös-Outfit;-1 173,00;56 508,56;;;;
257;2023-06-09;2023-06-09;2023-06-09;Överföring via internet;Tyg Mantel Fös-O;-42,00;57 681,56;;;;
258;2023-06-09;2023-06-09;2023-06-09;Överföring via internet;Halsband till Fö;-38,00;57 723,56;;;;
259;2023-06-09;2023-06-09;2023-06-09;Överföring via internet;Mötesmat Föset;-340,00;57 761,56;;;;
260;2023-06-09;2023-06-09;2023-06-09;Överföring via internet;83139741326862;13 076,39;58 101,56;;;;
261;2023-06-07;2023-06-07;2023-06-08;Bankgiro inbetalning;6428437;585,00;45 025,17;;;;
262;2023-06-05;2023-06-03;2023-06-03;Överföring via internet;83139741326862;-20 000,00;44 440,17;;;;
263;2023-06-05;2023-06-03;2023-06-03;Överföring via internet;Event fika;-316,00;64 440,17;;;;
264;2023-06-05;2023-06-03;2023-06-03;Överföring via internet;Alumnipub;-1 726,92;64 756,17;;;;
265;2023-06-05;2023-06-03;2023-06-03;Överföring via internet;Mat SRF SRpi;-133,00;66 483,09;;;;
266;2023-06-05;2023-06-03;2023-06-03;Överföring via internet;Revisormat;-85,00;66 616,09;;;;
267;2023-06-05;2023-06-03;2023-06-03;Överföring via internet;Event Fika;-110,50;66 701,09;;;;
268;2023-06-05;2023-06-03;2023-06-03;Överföring via internet;Intervju godis;-62,68;66 811,59;;;;
269;2023-06-05;2023-06-03;2023-06-03;Överföring via internet;Tandem;-89,80;66 874,27;;;;
270;2023-06-05;2023-06-03;2023-06-03;Överföring via internet;Vårskål;-224,70;66 964,07;;;;
271;2023-06-05;2023-06-03;2023-06-03;Överföring via internet;Outfit;-178,50;67 188,77;;;;
272;2023-06-05;2023-06-03;2023-06-03;Överföring via internet;Klättring;-800,00;67 367,27;;;;
273;2023-06-05;2023-06-03;2023-06-03;Överföring via internet;Outfit;-50,00;68 167,27;;;;
274;2023-06-05;2023-06-03;2023-06-03;Överföring via internet;Deisel;-393,20;68 217,27;;;;
275;2023-06-05;2023-06-03;2023-06-03;Överföring via internet;Outfit;-159,90;68 610,47;;;;
276;2023-06-05;2023-06-03;2023-06-03;Överföring via internet;Outfit;-1 869,00;68 770,37;;;;
277;2023-06-05;2023-06-03;2023-06-03;Överföring via internet;Intervjumat;-164,00;70 639,37;;;;
278;2023-06-02;2023-06-02;2023-06-05;Bankgiro inbetalning;6428437;23 000,00;70 803,37;;;;
279;2023-05-31;2023-05-31;2023-05-30;Överföring via internet;83139741326862;-6 000,00;47 803,37;;;;
280;2023-05-30;2023-05-30;2023-06-01;Bankgiro inbetalning;6428437;1 276,00;53 803,37;;;;
281;2023-05-23;2023-05-23;2023-05-23;Överföring via internet;83139741326862;-14 800,00;52 527,37;;;;
282;2023-05-19;2023-05-18;2023-05-18;Överföring via internet;Intervjumat;-255,00;67 327,37;;;;
283;2023-05-17;2023-05-17;2023-05-19;Bankgiro inbetalning;6428437;26 765,00;67 582,37;;;;
284;2023-05-17;2023-05-17;2023-05-17;Bg-bet. via internet;Saft Deltagareav;-3 750,00;40 817,37;;;;
285;2023-05-17;2023-05-17;2023-05-17;Överföring via internet;Laga NyckDep;-300,00;44 567,37;;;;
286;2023-05-17;2023-05-17;2023-05-17;Överföring via internet;Städartiklar;-171,80;44 867,37;;;;
287;2023-05-17;2023-05-17;2023-05-17;Överföring via internet;Revisormat;-85,00;45 039,17;;;;
288;2023-05-17;2023-05-17;2023-05-17;Överföring via internet;Blommor IKEA;-300,00;45 124,17;;;;
289;2023-05-17;2023-05-17;2023-05-17;Överföring via internet;Laga NyckDep;-300,00;45 424,17;;;;
290;2023-05-17;2023-05-17;2023-05-17;Överföring via internet;Laga NyckDep;-500,00;45 724,17;;;;
291;2023-05-17;2023-05-17;2023-05-17;Överföring via internet;Diesel;-1 192,11;46 224,17;;;;
292;2023-05-17;2023-05-17;2023-05-17;Överföring via internet;CeqPris;-1 200,00;47 416,28;;;;
293;2023-05-17;2023-05-17;2023-05-17;Överföring via internet;Intervjumat;-170,00;48 616,28;;;;
294;2023-05-17;2023-05-17;2023-05-17;Överföring via internet;NyckelDep;-500,00;48 786,28;;;;
295;2023-05-17;2023-05-17;2023-05-17;Överföring via internet;Nyckel Depositio;-300,00;49 286,28;;;;
296;2023-05-17;2023-05-17;2023-05-17;Överföring via internet;Laga NyckDep;-300,00;49 586,28;;;;
297;2023-05-17;2023-05-17;2023-05-17;Överföring via internet;Kontorsmaterial;-20,00;49 886,28;;;;
298;2023-05-17;2023-05-17;2023-05-17;Överföring via internet;NyckelDep;-300,00;49 906,28;;;;
299;2023-05-17;2023-05-17;2023-05-17;Överföring via internet;Syjunta;-203,00;50 206,28;;;;
300;2023-05-17;2023-05-17;2023-05-17;Överföring via internet;Laga NyckDep;-300,00;50 409,28;;;;
301;2023-05-17;2023-05-17;2023-05-17;Överföring via internet;Laga NyckDep;-300,00;50 709,28;;;;
302;2023-05-17;2023-05-17;2023-05-17;Överföring via internet;NyckelDep;-300,00;51 009,28;;;;
303;2023-05-17;2023-05-17;2023-05-17;Överföring via internet;Kontorsmaterial;-298,00;51 309,28;;;;
304;2023-05-17;2023-05-17;2023-05-17;Överföring via internet;NyckelDep;-300,00;51 607,28;;;;
305;2023-05-17;2023-05-17;2023-05-17;Överföring via internet;Bågfil;-129,00;51 907,28;;;;
306;2023-05-17;2023-05-17;2023-05-17;Överföring via internet;NyckelDep;-500,00;52 036,28;;;;
307;2023-05-17;2023-05-17;2023-05-17;Överföring via internet;Laga NyckDep;-300,00;52 536,28;;;;
308;2023-05-17;2023-05-17;2023-05-17;Överföring via internet;NyckelDep;-300,00;52 836,28;;;;
309;2023-05-17;2023-05-17;2023-05-17;Överföring via internet;Laga NyckDep;-300,00;53 136,28;;;;
310;2023-05-17;2023-05-17;2023-05-17;Överföring via internet;NyckelDep;-300,00;53 436,28;;;;
311;2023-05-17;2023-05-17;2023-05-17;Överföring via internet;Revisormat;-85,00;53 736,28;;;;
312;2023-05-17;2023-05-17;2023-05-17;Överföring via internet;Syjunta;-161,00;53 821,28;;;;
313;2023-05-17;2023-05-17;2023-05-17;Överföring via internet;Laga NyckDep;-300,00;53 982,28;;;;
314;2023-05-17;2023-05-17;2023-05-17;Överföring via internet;NyckelDep;-300,00;54 282,28;;;;
315;2023-05-17;2023-05-17;2023-05-17;Överföring via internet;Städ artiklar;-123,80;54 582,28;;;;
316;2023-05-17;2023-05-17;2023-05-17;Överföring via internet;Bokföringsmat;-85,00;54 706,08;;;;
317;2023-05-17;2023-05-17;2023-05-17;Överföring via internet;Syjunta;-55,00;54 791,08;;;;
318;2023-05-16;2023-05-16;2023-05-17;Bankgiro inbetalning;6428437;1 400,00;54 846,08;;;;
319;2023-05-16;2023-05-16;2023-05-16;Bg-bet. via internet;Hoodies Studierå;-2 476,00;53 446,08;;;;
320;2023-05-16;2023-05-16;2023-05-16;Överföring via internet;Internöverföring;-5 863,59;55 922,08;;;;
321;2023-05-16;2023-05-15;2023-05-15;Överföring via internet;83139741326862;23 000,00;61 785,67;;;;
322;2023-05-15;2023-05-15;2023-05-15;Bg-bet. via internet;Backvagnar (igen;-10 350,00;38 785,67;;;;
323;2023-05-15;2023-05-15;2023-05-15;Bg-bet. via internet;Bokslut + annat;-18 225,00;49 135,67;;;;
324;2023-05-15;2023-05-15;2023-05-15;Bg-bet. via internet;Tryckerikostnade;-135,13;67 360,67;;;;
325;2023-05-15;2023-05-15;2023-05-15;Bg-bet. via internet;Hallon Tandem;-210,00;67 495,80;;;;
326;2023-05-10;2023-05-09;2023-05-09;Överföring via internet;83139741326862;-4 000,00;67 705,80;;;;
327;2023-05-10;2023-05-10;2023-05-10;Överföring via internet;83139741326862;-6 000,00;71 705,80;;;;
328;2023-05-09;2023-05-09;2023-05-10;Bankgiro inbetalning;6428437;25 000,00;77 705,80;;;;
329;2023-05-09;2023-05-09;2023-05-09;Överföring via internet;83139741326862;-2 000,00;52 705,80;;;;
330;2023-05-09;2023-05-09;2023-05-09;Överföring via internet;83139741326862;-40 000,00;54 705,80;;;;
331;2023-05-08;2023-05-07;2023-05-07;Överföring via internet;83139741326862;-17 000,00;94 705,80;;;;
332;2023-05-03;2023-05-03;2023-05-03;Överföring via internet;83139741326862;-19 000,00;111 705,80;;;;
333;2023-05-02;2023-05-02;2023-05-02;Överföring via internet;83139741326862;-2 000,00;130 705,80;;;;
334;2023-05-02;2023-04-29;2023-04-29;Bg-bet. via internet;Kontorsmaterial;-3 816,00;132 705,80;;;;
335;2023-05-02;2023-04-29;2023-04-29;Bg-bet. via internet;Lokalhyra Skifte;-14 631,00;136 521,80;;;;
336;2023-05-02;2023-04-29;2023-04-29;Bg-bet. via internet;Livsmedelskontro;-2 674,00;151 152,80;;;;
337;2023-05-02;2023-04-29;2023-04-29;Bg-bet. via internet;Arbetskläder FNU;-4 897,00;153 826,80;;;;
338;2023-05-02;2023-04-29;2023-04-29;Bg-bet. via internet;Batterier 2;-1 607,00;158 723,80;;;;
339;2023-05-02;2023-04-29;2023-04-29;Bg-bet. via internet;Batterier 1;-1 348,00;160 330,80;;;;
340;2023-05-02;2023-04-29;2023-04-29;Överföring via internet;Present ING;-75,90;161 678,80;;;;
341;2023-05-02;2023-04-29;2023-04-29;Överföring via internet;Wii Inköp;-843,00;161 754,70;;;;
342;2023-05-02;2023-04-29;2023-04-29;Överföring via internet;ledningsSkål;-342,00;162 597,70;;;;
343;2023-05-02;2023-04-29;2023-04-29;Överföring via internet;Sprayfärg;-149,80;162 939,70;;;;
344;2023-05-02;2023-04-29;2023-04-29;Överföring via internet;Klättring;-800,00;163 089,50;;;;
345;2023-05-02;2023-04-29;2023-04-29;Överföring via internet;Värd Tack;-531,00;163 889,50;;;;
346;2023-05-02;2023-04-29;2023-04-29;Överföring via internet;Värd Tack;-592,00;164 420,50;;;;
347;2023-05-02;2023-04-29;2023-04-29;Överföring via internet;Tandemutrustning;-1 470,80;165 012,50;;;;
348;2023-05-02;2023-04-29;2023-04-29;Överföring via internet;VonTänen Testar;-100,00;166 483,30;;;;
349;2023-05-02;2023-04-29;2023-04-29;Överföring via internet;Tv fot;-187,09;166 583,30;;;;
350;2023-05-02;2023-04-29;2023-04-29;Överföring via internet;Värd tack;-657,55;166 770,39;;;;
351;2023-05-02;2023-04-29;2023-04-29;Överföring via internet;CykelPump;-129,00;167 427,94;;;;
352;2023-05-02;2023-04-29;2023-04-29;Överföring via internet;CEQ-pris;-1 200,00;167 556,94;;;;
353;2023-05-02;2023-04-29;2023-04-29;Överföring via internet;VonTänen;-20,90;168 756,94;;;;
354;2023-05-02;2023-04-29;2023-04-29;Överföring via internet;MötesMat;-510,00;168 777,84;;;;
355;2023-05-02;2023-04-29;2023-04-29;Överföring via internet;Wii;-600,00;169 287,84;;;;
356;2023-04-28;2023-04-28;2023-04-28;Pris avisering;1022304280018262;-10,00;169 887,84;;;;
357;2023-04-28;2023-04-28;2023-05-02;Internationell bet;1022304280018262;18 000,00;169 897,84;;;;
358;2023-04-28;2023-04-28;2023-04-28;Överföring via internet;Internöverföring;-4 400,00;151 897,84;;;;
359;2023-04-26;2023-04-26;2023-04-27;Bankgiro inbetalning;6428437;50,00;156 297,84;;;;
360;2023-04-25;2023-04-25;2023-04-25;Överföring via internet;83139741326862;-4 000,00;156 247,84;;;;
361;2023-04-24;2023-04-24;2023-04-24;Överföring via internet;83139741326862;-5 000,00;160 247,84;;;;
362;2023-04-21;2023-04-21;2023-04-21;Överföring via internet;Återbetalning Fa;-250,00;165 247,84;;;;
363;2023-04-20;2023-04-20;2023-04-21;Bankgiro inbetalning;6428437;134 075,00;165 497,84;;;;
364;2023-04-18;2023-04-18;2023-04-19;Bankgiro inbetalning;6428437;150,00;31 422,84;;;;
365;2023-04-12;2023-04-12;2023-04-12;Överföring via internet;83139741326862;-1 400,00;31 272,84;;;;
366;2023-04-11;2023-04-11;2023-04-12;Bankgiro inbetalning;6428437;20 000,00;32 672,84;;;;
367;2023-04-11;2023-04-11;2023-04-11;Bg-bet. via internet;Förköp ÖG Fadder;-7 800,00;12 672,84;;;;
368;2023-04-11;2023-04-11;2023-04-11;Bg-bet. via internet;Tryckerikostnade;-1 882,00;20 472,84;;;;
369;2023-04-11;2023-04-11;2023-04-11;Bg-bet. via internet;Hoppborg Skvalbo;-2 500,00;22 354,84;;;;
370;2023-04-03;2023-04-03;2023-04-04;Bankgiro inbetalning;6428437;100,00;24 854,84;;;;
371;2023-04-03;2023-04-03;2023-04-03;Överföring via internet;83139741326862;-1,00;24 754,84;;;;
372;2023-03-30;2023-03-30;2023-03-30;Bg-bet. via internet;Betalning Saft 2;-398,00;24 755,84;;;;
373;2023-03-30;2023-03-30;2023-03-30;Bg-bet. via internet;Buss Ölreise;-10 995,00;25 153,84;;;;
374;2023-03-30;2023-03-30;2023-03-30;Överföring via internet;Mat till Proposi;-85,00;36 148,84;;;;
375;2023-03-30;2023-03-30;2023-03-30;Överföring via internet;Mat till Proposi;-425,00;36 233,84;;;;
376;2023-03-30;2023-03-30;2023-03-30;Överföring via internet;Medaljutdelning;-396,00;36 658,84;;;;
377;2023-03-30;2023-03-30;2023-03-30;Överföring via internet;Revisormat;-61,00;37 054,84;;;;
378;2023-03-30;2023-03-30;2023-03-30;Överföring via internet;Värdtack FARAD;-518,10;37 115,84;;;;
379;2023-03-30;2023-03-30;2023-03-30;Överföring via internet;Vontänen Släpp;-79,00;37 633,94;;;;
380;2023-03-30;2023-03-30;2023-03-30;Överföring via internet;Fika Likabehandl;-311,40;37 712,94;;;;
381;2023-03-30;2023-03-30;2023-03-30;Överföring via internet;Bokföringsmat;-85,00;38 024,34;;;;
382;2023-03-30;2023-03-30;2023-03-30;Överföring via internet;Revisormat;-84,70;38 109,34;;;;
383;2023-03-30;2023-03-30;2023-03-30;Överföring via internet;Syjunta Material;-298,00;38 194,04;;;;
384;2023-03-30;2023-03-30;2023-03-30;Överföring via internet;Mat till protoko;-571,00;38 492,04;;;;
385;2023-03-30;2023-03-30;2023-03-30;Överföring via internet;Fika Likabehandl;-494,80;39 063,04;;;;
386;2023-03-30;2023-03-30;2023-03-30;Överföring via internet;Mat till Proposi;-85,00;39 557,84;;;;
387;2023-03-30;2023-03-30;2023-03-30;Överföring via internet;Revisormat;-170,00;39 642,84;;;;
388;2023-03-29;2023-03-29;2023-03-30;Bankgiro inbetalning;6428437;195,00;39 812,84;;;;
389;2023-03-29;2023-03-29;2023-03-29;Överföring via internet;Internöverföring;-17 000,00;39 617,84;;;;
390;2023-03-28;2023-03-28;2023-03-28;Överföring via internet;83139741326862;-7 500,00;56 617,84;;;;
391;2023-03-27;2023-03-27;2023-03-28;Bankgiro inbetalning;6428437;510,00;64 117,84;;;;
392;2023-03-27;2023-03-25;2023-03-25;Överföring via internet;83139741326870;-15 000,00;63 607,84;;;;
393;2023-03-24;2023-03-24;2023-03-24;Pg-bet. via internet;Betalning Fotbol;-1 500,00;78 607,84;;;;
394;2023-03-22;2023-03-22;2023-03-22;Överföring via internet;Intervjumat;-170,00;80 107,84;;;;
395;2023-03-22;2023-03-22;2023-03-22;Överföring via internet;Intervjumat;-170,00;80 277,84;;;;
396;2023-03-22;2023-03-22;2023-03-22;Överföring via internet;Intervjumat;-85,00;80 447,84;;;;
397;2023-03-22;2023-03-22;2023-03-22;Överföring via internet;Intervjumat;-170,00;80 532,84;;;;
398;2023-03-22;2023-03-22;2023-03-22;Överföring via internet;Intervjumat;-170,00;80 702,84;;;;
399;2023-03-22;2023-03-22;2023-03-22;Överföring via internet;Intervjumat;-85,00;80 872,84;;;;
400;2023-03-22;2023-03-22;2023-03-22;Överföring via internet;Intervjumat;-255,00;80 957,84;;;;
401;2023-03-22;2023-03-22;2023-03-22;Överföring via internet;Intervjumat;-85,00;81 212,84;;;;
402;2023-03-22;2023-03-22;2023-03-22;Överföring via internet;Intervjumat;-85,00;81 297,84;;;;
403;2023-03-21;2023-03-21;2023-03-21;Bg-bet. via internet;Fordonsskatt;-1 733,00;81 382,84;;;;
404;2023-03-21;2023-03-21;2023-03-21;Bg-bet. via internet;Farad Bord o Sto;-13 238,00;83 115,84;;;;
405;2023-03-21;2023-03-21;2023-03-21;Överföring via internet;CykelSaker;-958,20;96 353,84;;;;
406;2023-03-21;2023-03-21;2023-03-21;Överföring via internet;Revisormat;-170,00;97 312,04;;;;
407;2023-03-21;2023-03-21;2023-03-21;Överföring via internet;Bokföringsmat;-80,00;97 482,04;;;;
408;2023-03-21;2023-03-21;2023-03-21;Överföring via internet;Parkering;-143,00;97 562,04;;;;
409;2023-03-21;2023-03-21;2023-03-21;Överföring via internet;Bokföringsmat;-85,00;97 705,04;;;;
410;2023-03-20;2023-03-20;2023-03-20;Överföring via internet;Internöverföring;12 689,00;97 790,04;;;;
411;2023-03-20;2023-03-20;2023-03-20;Överföring via internet;Internövföring;-7 000,00;85 101,04;;;;
412;2023-03-15;2023-03-15;2023-03-16;Bankgiro inbetalning;6428437;270,00;92 101,04;;;;
413;2023-03-13;2023-03-13;2023-03-14;Bankgiro inbetalning;6428437;175,00;91 831,04;;;;
414;2023-03-13;2023-03-13;2023-03-13;Pris avisering;1022303130010591;-10,00;91 656,04;;;;
415;2023-03-13;2023-03-13;2023-03-14;Internationell bet;1022303130010591;4 000,00;91 666,04;;;;
416;2023-03-10;2023-03-10;2023-03-13;Bankgiro inbetalning;6428437;4 590,00;87 666,04;;;;
417;2023-03-08;2023-03-08;2023-03-09;Bankgiro inbetalning;6428437;57,06;83 076,04;;;;
418;2023-03-08;2023-03-08;2023-03-08;Bg-bet. via internet;EHusetTryckeri;-403,00;83 018,98;;;;
419;2023-03-08;2023-03-08;2023-03-08;Bg-bet. via internet;Farad Parkering;-120,00;83 421,98;;;;
420;2023-03-08;2023-03-08;2023-03-08;Bg-bet. via internet;Farad Mattor;-2 100,00;83 541,98;;;;
421;2023-03-08;2023-03-08;2023-03-08;Bg-bet. via internet;Mikrofoner;-5 000,00;85 641,98;;;;
422;2023-03-08;2023-03-08;2023-03-08;Överföring via internet;Revisorsmat;-84,70;90 641,98;;;;
423;2023-03-08;2023-03-08;2023-03-08;Överföring via internet;godis smurf;-279,33;90 726,68;;;;
424;2023-03-08;2023-03-08;2023-03-08;Överföring via internet;Revisorsmat;-64,00;91 006,01;;;;
425;2023-03-08;2023-03-08;2023-03-08;Överföring via internet;Bokföringsmat;-85,00;91 070,01;;;;
426;2023-03-08;2023-03-08;2023-03-08;Överföring via internet;Transformator;-2 627,00;91 155,01;;;;
427;2023-03-08;2023-03-08;2023-03-08;Överföring via internet;Tandem;-3 500,00;93 782,01;;;;
428;2023-03-08;2023-03-08;2023-03-08;Överföring via internet;K sek Present;-399,00;97 282,01;;;;
429;2023-03-08;2023-03-08;2023-03-08;Överföring via internet;@1337 Fika;-104,70;97 681,01;;;;
430;2023-03-08;2023-03-08;2023-03-08;Överföring via internet;Milersättning;-185,00;97 785,71;;;;
431;2023-03-08;2023-03-08;2023-03-08;Överföring via internet;code sprint mat;-834,00;97 970,71;;;;
432;2023-03-08;2023-03-08;2023-03-08;Överföring via internet;Klubbor;-150,00;98 804,71;;;;
433;2023-03-08;2023-03-08;2023-03-08;Överföring via internet;Revisorsmat;-170,00;98 954,71;;;;
434;2023-03-08;2023-03-08;2023-03-08;Överföring via internet;Ljus;-114,75;99 124,71;;;;
435;2023-03-08;2023-03-08;2023-03-08;Överföring via internet;Farad Märken;-1 246,00;99 239,46;;;;
436;2023-03-08;2023-03-08;2023-03-08;Överföring via internet;Revisorsmat;-85,00;100 485,46;;;;
437;2023-03-07;2023-03-07;2023-03-08;Bankgiro inbetalning;6428437;556,32;100 570,46;;;;
438;2023-03-06;2023-03-06;2023-03-07;Bankgiro inbetalning;6428437;20 000,00;100 014,14;;;;
439;2023-03-03;2023-03-03;2023-03-06;Bankgiro inbetalning;6428437;133,00;80 014,14;;;;
440;2023-03-03;2023-03-03;2023-03-03;Bg-bet. via internet;Betalning Domän;-236,25;79 881,14;;;;
441;2023-03-02;2023-03-02;2023-03-03;Bankgiro inbetalning;6428437;2 000,00;80 117,39;;;;
442;2023-03-01;2023-03-01;2023-03-02;Bankgiro inbetalning;6428437;450,00;78 117,39;;;;
443;2023-03-01;2023-03-01;2023-03-01;Överföring via internet;Intervjumat;-80,00;77 667,39;;;;
444;2023-03-01;2023-03-01;2023-03-01;Överföring via internet;Intervjumat;-80,00;77 747,39;;;;
445;2023-03-01;2023-03-01;2023-03-01;Överföring via internet;Intervjumat;-57,53;77 827,39;;;;
446;2023-03-01;2023-03-01;2023-03-01;Överföring via internet;Intervjumat;-68,80;77 884,92;;;;
447;2023-02-28;2023-02-28;2023-03-01;Bankgiro inbetalning;6428437;225,00;77 953,72;;;;
448;2023-02-28;2023-02-28;2023-02-28;Överföring via internet;Intervjumat;-72,00;77 728,72;;;;
449;2023-02-28;2023-02-28;2023-02-28;Överföring via internet;Intervjumat;-80,00;77 800,72;;;;
450;2023-02-28;2023-02-28;2023-02-28;Överföring via internet;Intervjumat;-82,00;77 880,72;;;;
451;2023-02-28;2023-02-28;2023-02-28;Överföring via internet;Intervjumat;-73,00;77 962,72;;;;
452;2023-02-28;2023-02-28;2023-02-28;Överföring via internet;Intervjumat;-80,00;78 035,72;;;;
453;2023-02-28;2023-02-28;2023-02-28;Överföring via internet;Intervjumat;-85,00;78 115,72;;;;
454;2023-02-28;2023-02-28;2023-02-28;Överföring via internet;Intervjumat;-85,00;78 200,72;;;;
455;2023-02-28;2023-02-28;2023-02-28;Överföring via internet;Intervjumat;-170,00;78 285,72;;;;
456;2023-02-28;2023-02-28;2023-02-28;Överföring via internet;Intervjumat;-85,00;78 455,72;;;;
457;2023-02-28;2023-02-28;2023-02-28;Överföring via internet;Intervjumat;-255,00;78 540,72;;;;
458;2023-02-28;2023-02-28;2023-02-28;Överföring via internet;Intervjumat;-85,00;78 795,72;;;;
459;2023-02-28;2023-02-28;2023-02-28;Överföring via internet;Intervjumat;-68,00;78 880,72;;;;
460;2023-02-28;2023-02-28;2023-02-28;Överföring via internet;Intervjumat;-76,00;78 948,72;;;;
461;2023-02-28;2023-02-28;2023-02-28;Överföring via internet;Intervjumat;-82,00;79 024,72;;;;
462;2023-02-27;2023-02-27;2023-02-28;Bankgiro inbetalning;6428437;590,00;79 106,72;;;;
463;2023-02-27;2023-02-27;2023-02-27;Bg-bet. via internet;Sexet Brodyr;-7 237,50;78 516,72;;;;
464;2023-02-27;2023-02-27;2023-02-27;Överföring via internet;FNU Kick Off;-380,56;85 754,22;;;;
465;2023-02-27;2023-02-27;2023-02-27;Överföring via internet;Carrom bräde;-1 244,80;86 134,78;;;;
466;2023-02-27;2023-02-27;2023-02-27;Överföring via internet;CEQ-mat;-61,00;87 379,58;;;;
467;2023-02-27;2023-02-27;2023-02-27;Överföring via internet;Svetshjälm;-250,00;87 440,58;;;;
468;2023-02-27;2023-02-27;2023-02-27;Överföring via internet;Svetsförkläde;-499,00;87 690,58;;;;
469;2023-02-27;2023-02-27;2023-02-27;Överföring via internet;Svetshandskar;-119,00;88 189,58;;;;
470;2023-02-27;2023-02-27;2023-02-27;Överföring via internet;Pingisbordsfrakt;-66,60;88 308,58;;;;
471;2023-02-24;2023-02-24;2023-02-24;Överföring via internet;83139741326862;-17 000,00;88 375,18;;;;
472;2023-02-24;2023-02-24;2023-02-24;Överföring via internet;83139741326862;-15 000,00;105 375,18;;;;
473;2023-02-24;2023-02-24;2023-02-24;Överföring via internet;Internöverföring;100 000,00;120 375,18;;;;
474;2023-02-23;2023-02-23;2023-02-23;Överföring via internet;Internöverföring;-10 240,00;20 375,18;;;;
475;2023-02-22;2023-02-22;2023-02-22;Överföring via internet;Intervjumat;-150,00;30 615,18;;;;
476;2023-02-22;2023-02-22;2023-02-22;Överföring via internet;Arbetskläder FAR;-3 200,00;30 765,18;;;;
477;2023-02-21;2023-02-21;2023-02-21;Överföring via internet;Internöverföring;30 000,00;33 965,18;;;;
478;2023-02-20;2023-02-20;2023-02-20;Överföring via internet;83139741326862;-2 200,00;3 965,18;;;;
479;2023-02-20;2023-02-18;2023-02-18;Överföring via internet;83139741326862;-1 000,00;6 165,18;;;;
480;2023-02-20;2023-02-18;2023-02-18;Överföring via internet;83139741326862;-2 000,00;7 165,18;;;;
481;2023-02-17;2023-02-17;2023-02-17;Bg-bet. via internet;Funktionärstack;-36 750,00;9 165,18;;;;
482;2023-02-17;2023-02-17;2023-02-17;Bg-bet. via internet;Utskottstack;-26 000,00;45 915,18;;;;
483;2023-02-17;2023-02-17;2023-02-17;Pg-bet. via internet;Pingisbollar;-389,00;71 915,18;;;;
484;2023-02-17;2023-02-17;2023-02-17;Pg-bet. via internet;AnmälanFotboll;-1 600,00;72 304,18;;;;
485;2023-02-17;2023-02-17;2023-02-17;Pg-bet. via internet;AnmälanVolleybol;-1 300,00;73 904,18;;;;
486;2023-02-17;2023-02-17;2023-02-17;Överföring via internet;Donation Regnbåg;-1 735,50;75 204,18;;;;
487;2023-02-17;2023-02-17;2023-02-17;Överföring via internet;Revisormat;-170,00;76 939,68;;;;
488;2023-02-17;2023-02-17;2023-02-17;Överföring via internet;83139742551138;30 000,00;77 109,68;;;;
489;2023-02-17;2023-02-17;2023-02-17;Överföring via internet;Milersättning;-185,00;47 109,68;;;;
490;2023-02-17;2023-02-17;2023-02-17;Överföring via internet;PingisPriser;-84,00;47 294,68;;;;
491;2023-02-17;2023-02-17;2023-02-17;Överföring via internet;Bokföringsmat;-85,00;47 378,68;;;;
492;2023-02-17;2023-02-17;2023-02-17;Överföring via internet;FARAD;-2 705,81;47 463,68;;;;
493;2023-02-17;2023-02-17;2023-02-17;Överföring via internet;83139742551138;20 000,00;50 169,49;;;;
494;2023-02-17;2023-02-17;2023-02-17;Överföring via internet;Milersättning;-203,50;30 169,49;;;;
495;2023-02-17;2023-02-17;2023-02-17;Överföring via internet;Internöverföring;30 000,00;30 372,99;;;;
496;2023-02-17;2023-02-17;2023-02-17;Överföring via internet;Alkohol KMtack;-3 933,40;372,99;;;;
497;2023-02-17;2023-02-17;2023-02-17;Överföring via internet;Bokföringsmat;-85,00;4 306,39;;;;
498;2023-02-16;2023-02-16;2023-02-17;Bankgiro inbetalning;6428437;390,00;4 391,39;;;;
499;2023-02-14;2023-02-14;2023-02-15;Bankgiro inbetalning;6428437;4 500,00;4 001,39;;;;
500;2023-02-14;2023-02-14;2023-02-14;Överföring via internet;Farad;-565,00;-498,61;;;;
501;2023-02-14;2023-02-14;2023-02-14;Överföring via internet;LedningsskifteMa;-251,20;66,39;;;;
502;2023-02-14;2023-02-14;2023-02-14;Överföring via internet;Farad;-17,90;317,59;;;;
503;2023-02-14;2023-02-14;2023-02-14;Överföring via internet;Farad;-286,42;335,49;;;;
504;2023-02-14;2023-02-14;2023-02-14;Överföring via internet;Farad;-1 938,69;621,91;;;;
505;2023-02-14;2023-02-14;2023-02-14;Överföring via internet;Ceq Tävlingspris;-1 200,00;2 560,60;;;;
506;2023-02-14;2023-02-14;2023-02-14;Överföring via internet;Intervjumat;-85,00;3 760,60;;;;
507;2023-02-14;2023-02-14;2023-02-14;Överföring via internet;KakorHTF;-46,50;3 845,60;;;;
508;2023-02-14;2023-02-14;2023-02-14;Överföring via internet;Farad;-42,90;3 892,10;;;;
509;2023-02-14;2023-02-14;2023-02-14;Överföring via internet;LedningsskifteMa;-396,00;3 935,00;;;;
510;2023-02-13;2023-02-13;2023-02-14;Bankgiro inbetalning;6428437;800,00;4 331,00;;;;
511;2023-02-13;2023-02-13;2023-02-13;Bg-bet. via internet;Tryckeri;-1 832,00;3 531,00;;;;
512;2023-02-13;2023-02-13;2023-02-13;Bg-bet. via internet;Bussar FlyING;-11 560,00;5 363,00;;;;
513;2023-02-13;2023-02-13;2023-02-13;Bg-bet. via internet;Släpp Lophtet;-2 400,00;16 923,00;;;;
514;2023-02-13;2023-02-13;2023-02-13;Bg-bet. via internet;Symaskiner;-5 580,00;19 323,00;;;;
515;2023-02-13;2023-02-13;2023-02-13;Bg-bet. via internet;Tillbehör Symask;-599,00;24 903,00;;;;
516;2023-02-13;2023-02-13;2023-02-13;Bg-bet. via internet;Tacksittning;-10 880,00;25 502,00;;;;
517;2023-02-13;2023-02-13;2023-02-13;Bg-bet. via internet;+1 sittning Loph;-2 575,00;36 382,00;;;;
518;2023-02-13;2023-02-13;2023-02-13;Överföring via internet;83139742551138;20 000,00;38 957,00;;;;
519;2023-02-13;2023-02-13;2023-02-13;Överföring via internet;Diverse Tacksitt;-188,15;18 957,00;;;;
520;2023-02-13;2023-02-13;2023-02-13;Överföring via internet;Alkohol tacksitt;-3 140,40;19 145,15;;;;
521;2023-02-13;2023-02-13;2023-02-13;Överföring via internet;Internövföring;-20 000,00;22 285,55;;;;
522;2023-02-13;2023-02-11;2023-02-11;Överföring via internet;83139741326862;-49,50;42 285,55;;;;
523;2023-02-10;2023-02-10;2023-02-13;Bankgiro inbetalning;6428437;595,00;42 335,05;;;;
524;2023-02-09;2023-02-09;2023-02-09;Överföring via internet;83139741326862;4 200,00;41 740,05;;;;
525;2023-02-08;2023-02-08;2023-02-08;Bg-bet. via internet;AspiaBetalning;-2 772,50;37 540,05;;;;
526;2023-02-08;2023-02-08;2023-02-08;Bg-bet. via internet;GoGSalladFARAD;-8 062,00;40 312,55;;;;
527;2023-02-08;2023-02-08;2023-02-08;Bg-bet. via internet;EHusetTryckeri;-2 537,00;48 374,55;;;;
528;2023-02-08;2023-02-08;2023-02-08;Bg-bet. via internet;SexetKablar;-250,00;50 911,55;;;;
529;2023-02-08;2023-02-08;2023-02-08;Bg-bet. via internet;Lophtet Sexetkic;-2 500,00;51 161,55;;;;
530;2023-02-08;2023-02-08;2023-02-08;Överföring via internet;Intervjumat;-170,00;53 661,55;;;;
531;2023-02-08;2023-02-08;2023-02-08;Överföring via internet;AlkoholFARADPub;-2 798,50;53 831,55;;;;
532;2023-02-08;2023-02-08;2023-02-08;Överföring via internet;Bänkolja;-99,90;56 630,05;;;;
533;2023-02-08;2023-02-08;2023-02-08;Överföring via internet;AllaHjärtansDag;-100,00;56 729,95;;;;
534;2023-02-08;2023-02-08;2023-02-08;Överföring via internet;AllaHjärtansDag;-60,00;56 829,95;;;;
535;2023-02-08;2023-02-08;2023-02-08;Överföring via internet;LedningsSkifte;-4 769,43;56 889,95;;;;
536;2023-02-08;2023-02-08;2023-02-08;Överföring via internet;AllaHjärtansDag;-454,60;61 659,38;;;;
537;2023-02-08;2023-02-08;2023-02-08;Överföring via internet;Internöverföring;-5 000,00;62 113,98;;;;
538;2023-02-08;2023-02-08;2023-02-08;Överföring via internet;AllaHjärtansDag;-195,50;67 113,98;;;;
539;2023-02-08;2023-02-08;2023-02-08;Överföring via internet;83139741326847;50 000,00;67 309,48;;;;
540;2023-02-07;2023-02-07;2023-02-07;Bg-bet. via internet;Bilreperation;-6 289,00;17 309,48;;;;
541;2023-02-07;2023-02-07;2023-02-07;Överföring via internet;83139741326862;-10 880,00;23 598,48;;;;
542;2023-02-07;2023-02-07;2023-02-07;Överföring via internet;InternÖvf;21 152,73;34 478,48;;;;
543;2023-02-06;2023-02-06;2023-02-06;Överföring via internet;83139741326862;590,00;13 325,75;;;;
544;2023-02-03;2023-02-03;2023-02-03;Överföring via internet;UtbildningFNU;-500,00;12 735,75;;;;
545;2023-02-03;2023-02-03;2023-02-03;Överföring via internet;MattejpFARAD;-1 791,00;13 235,75;;;;
546;2023-02-03;2023-02-03;2023-02-03;Överföring via internet;Bokföringsmat;-85,00;15 026,75;;;;
547;2023-02-03;2023-02-03;2023-02-03;Överföring via internet;Lunchföreläsning;-119,00;15 111,75;;;;
548;2023-02-02;2023-02-02;2023-02-02;Överföring via internet;83139741326862;-14 000,00;15 230,75;;;;
549;2023-02-01;2023-02-01;2023-02-01;Bg-bet. via internet;SaftUmeåVT22;-800,00;29 230,75;;;;
550;2023-02-01;2023-02-01;2023-02-01;Överföring via internet;Kostym SåS;-175,90;30 030,75;;;;
551;2023-02-01;2023-02-01;2023-02-01;Överföring via internet;FaradFika;-540,50;30 206,65;;;;
552;2023-02-01;2023-02-01;2023-02-01;Överföring via internet;Dricka och snack;-341,00;30 747,15;;;;
553;2023-02-01;2023-02-01;2023-02-01;Överföring via internet;Alkoholcaftack;-1 104,00;31 088,15;;;;
554;2023-02-01;2023-02-01;2023-02-01;Överföring via internet;såsmat rep;-490,59;32 192,15;;;;
555;2023-02-01;2023-02-01;2023-02-01;Överföring via internet;FaradMat;-5 101,50;32 682,74;;;;
556;2023-02-01;2023-02-01;2023-02-01;Överföring via internet;såsmat rep;-117,80;37 784,24;;;;
557;2023-02-01;2023-02-01;2023-02-01;Överföring via internet;AlkTackSex;-1 877,60;37 902,04;;;;
558;2023-02-01;2023-02-01;2023-02-01;Överföring via internet;Värdutbildning;-83,30;39 779,64;;;;
559;2023-02-01;2023-02-01;2023-02-01;Överföring via internet;Kostym SåS;-791,75;39 862,94;;;;
560;2023-02-01;2023-02-01;2023-02-01;Överföring via internet;AlkoholPryltack;-1 272,00;40 654,69;;;;
561;2023-02-01;2023-02-01;2023-02-01;Överföring via internet;alkfriPryTack;-250,59;41 926,69;;;;
562;2023-02-01;2023-02-01;2023-02-01;Överföring via internet;Ansvarspostutbil;-1 947,00;42 177,28;;;;
563;2023-02-01;2023-02-01;2023-02-01;Överföring via internet;FaradTejp;-39,90;44 124,28;;;;
564;2023-02-01;2023-02-01;2023-02-01;Överföring via internet;SkåpLås;-1 996,00;44 164,18;;;;
565;2023-02-01;2023-02-01;2023-02-01;Överföring via internet;83139741326862;-700,00;46 160,18;;;;
566;2023-01-30;2023-01-30;2023-01-30;Bg-bet. via internet;SkiftesStuga;-7 000,00;46 860,18;;;;
567;2023-01-30;2023-01-30;2023-01-30;Överföring via internet;83139741326862;-1 000,00;53 860,18;;;;
568;2023-01-27;2023-01-27;2023-01-27;Överföring via internet;83139741326862;-7 000,00;54 860,18;;;;
569;2023-01-27;2023-01-27;2023-01-27;Överföring via internet;83139741326862;-1 500,00;61 860,18;;;;
570;2023-01-24;2023-01-24;2023-01-24;Bg-bet. via internet;Hyra Ishall;-400,00;63 360,18;;;;
571;2023-01-24;2023-01-24;2023-01-24;Pg-bet. via internet;PingisBollar;-468,00;63 760,18;;;;
572;2023-01-24;2023-01-24;2023-01-24;Överföring via internet;MatSyrelseUtbild;-700,00;64 228,18;;;;
573;2023-01-24;2023-01-24;2023-01-24;Överföring via internet;Mat Bordsvise;-220,00;64 928,18;;;;
574;2023-01-24;2023-01-24;2023-01-24;Överföring via internet;AuxBil;-39,90;65 148,18;;;;
575;2023-01-24;2023-01-24;2023-01-24;Överföring via internet;Bar Bordsvise;-380,00;65 188,08;;;;
576;2023-01-24;2023-01-24;2023-01-24;Överföring via internet;TipEx Lim;-78,80;65 568,08;;;;
577;2023-01-24;2023-01-24;2023-01-24;Överföring via internet;Diesel F-bil;-1 061,28;65 646,88;;;;
578;2023-01-24;2023-01-24;2023-01-24;Överföring via internet;Mat Reptillfälle;-919,32;66 708,16;;;;
579;2023-01-24;2023-01-24;2023-01-24;Överföring via internet;Scenkläder;-309,50;67 627,48;;;;
580;2023-01-24;2023-01-24;2023-01-24;Överföring via internet;CafeLås;-449,00;67 936,98;;;;
581;2023-01-24;2023-01-24;2023-01-24;Överföring via internet;Mat Bordsvise;-2 156,00;68 385,98;;;;
582;2023-01-24;2023-01-24;2023-01-24;Överföring via internet;Cafe Nycklar;-280,00;70 541,98;;;;
583;2023-01-24;2023-01-24;2023-01-24;Överföring via internet;Alk Bordsvise;-627,00;70 821,98;;;;
584;2023-01-24;2023-01-24;2023-01-24;Överföring via internet;Diesel F-bil;-1 198,24;71 448,98;;;;
585;2023-01-24;2023-01-24;2023-01-24;Överföring via internet;Alkohol LednTack;-2 350,20;72 647,22;;;;
586;2023-01-24;2023-01-24;2023-01-24;Överföring via internet;Bokföringsmat;-170,00;74 997,42;;;;
587;2023-01-24;2023-01-24;2023-01-24;Överföring via internet;Scenkläder;-105,00;75 167,42;;;;
588;2023-01-24;2023-01-24;2023-01-24;Överföring via internet;Scenkläder;-1 036,00;75 272,42;;;;
589;2023-01-24;2023-01-24;2023-01-24;Överföring via internet;Scenkläder;-185,00;76 308,42;;;;
590;2023-01-23;2023-01-23;2023-01-23;Bg-bet. via internet;Bilförsäkring;-1 952,00;76 493,42;;;;
591;2023-01-23;2023-01-23;2023-01-23;Överföring via internet;Internöverföring;-1 400,00;78 445,42;;;;
592;2023-01-23;2023-01-23;2023-01-23;Överföring via internet;83139741326862;-800,00;79 845,42;;;;
593;2023-01-20;2023-01-20;2023-01-20;Pris banktjänster enligt faktura;;-1 212,00;80 645,42;;;;
594;2023-01-18;2023-01-18;2023-01-18;Pris avisering;1022301180007526;-10,00;81 857,42;;;;
595;2023-01-18;2023-01-18;2023-01-18;Pris betalning;1022301180007526;-1,50;81 867,42;;;;
596;2023-01-18;2023-01-18;2023-01-19;Europabetalning;1022301180007526;525,00;81 868,92;;;;
597;2023-01-17;2023-01-17;2023-01-18;Bankgiro inbetalning;6428437;1 606,00;81 343,92;;;;
598;2023-01-17;2023-01-17;2023-01-17;Bg-bet. via internet;Adobe creative c;-6 243,00;79 737,92;;;;
599;2023-01-17;2023-01-16;2023-01-16;Överföring via internet;Internöverföring;-20 000,00;85 980,92;;;;
600;2023-01-16;2023-01-16;2023-01-17;Bankgiro inbetalning;6428437;220,00;105 980,92;;;;
601;2023-01-13;2023-01-13;2023-01-13;Bg-bet. via internet;LUNDS KOMMUN;-1 200,00;105 760,92;;;;
602;2023-01-12;2023-01-12;2023-01-13;Bankgiro inbetalning;6428437;36 000,00;106 960,92;;;;
603;2023-01-12;2023-01-12;2023-01-12;Bg-bet. via internet;FETSM 1;-1 400,00;70 960,92;;;;
604;2023-01-12;2023-01-11;2023-01-11;Bg-bet. via internet;Tillstånd Farad;-1 400,00;72 360,92;;;;
605;2023-01-12;2023-01-11;2023-01-11;Bg-bet. via internet;Tillstånd Farad;-1 400,00;73 760,92;;;;
606;2023-01-11;2023-01-11;2023-01-12;Bankgiro inbetalning;6428437;1 180,00;75 160,92;;;;
607;2023-01-11;2023-01-11;2023-01-11;Bg-bet. via internet;Hyra gasque SING;-16 110,00;73 980,92;;;;
608;2023-01-11;2023-01-11;2023-01-11;Bg-bet. via internet;E-tryckeriet;-5 947,00;90 090,92;;;;
609;2023-01-11;2023-01-11;2023-01-11;Bg-bet. via internet;Hyra Cornelis St;-3 800,00;96 037,92;;;;
610;2023-01-11;2023-01-11;2023-01-11;Bg-bet. via internet;Hyra Nollegasque;-34 290,00;99 837,92;;;;
611;2023-01-11;2023-01-11;2023-01-11;Bg-bet. via internet;Hyra Gasque Jubi;-24 595,00;134 127,92;;;;
612;2023-01-11;2023-01-11;2023-01-11;Överföring via internet;Intervjumat;-85,00;158 722,92;;;;
613;2023-01-11;2023-01-11;2023-01-11;Överföring via internet;Bokföringsmat;-170,00;158 807,92;;;;
614;2023-01-11;2023-01-11;2023-01-11;Överföring via internet;Internöverföring;80 000,00;158 977,92;;;;
615;2023-01-11;2023-01-11;2023-01-11;Överföring via internet;Ledningstack;-3 457,70;78 977,92;;;;
616;2023-01-11;2023-01-11;2023-01-11;Överföring via internet;Bokföringsmat;-85,00;82 435,62;;;;
617;2023-01-11;2023-01-11;2023-01-11;Överföring via internet;Bokföringsmat;-85,00;82 520,62;;;;
618;2023-01-04;2023-01-04;2023-01-05;Bankgiro inbetalning;6428437;150,00;82 605,62;;;;
619;2023-01-03;2023-01-03;2023-01-04;Bankgiro inbetalning;6428437;2 000,00;82 455,62;;;;
620;2023-01-02;2023-01-02;2023-01-03;Bankgiro inbetalning;6428437;47 504,00;80 455,62;;;;
