* Transaktionsrapport Period 2023-01-01 – 2023-11-02 Skapad 2023-11-02 00:57 CET
Radnr,Clnr,Kontonr,Produkt,Valuta,Bokfdag,Transdag,Valutadag,Referens,Text,Belopp,Saldo
1,83139,0742551138,"Placerkto Företag",SEK,2023-02-13,2023-02-13,2023-02-13,"Internöverföring","Överföring via internet",-20000.00,473393.05
2,83139,0742551138,"Placerkto Företag",SEK,2023-02-17,2023-02-17,2023-02-17,"Internöverföring","Överföring via internet",-30000.00,443393.05
3,83139,0742551138,"Placerkto Företag",SEK,2023-02-17,2023-02-17,2023-02-17,"Internöverföring","Överföring via internet",-20000.00,423393.05
4,83139,0742551138,"Placerkto Företag",SEK,2023-02-17,2023-02-17,2023-02-17,"Internöverföring","Överföring via internet",-30000.00,393393.05
5,83139,0742551138,"Placerkto Företag",SEK,2023-02-21,2023-02-21,2023-02-21,"Internöverföring","Överföring via internet",-30000.00,363393.05
6,83139,0742551138,"Placerkto Företag",SEK,2023-02-24,2023-02-24,2023-02-24,"Internöverföring","Överföring via internet",-100000.00,263393.05
7,83139,0742551138,"Placerkto Företag",SEK,2023-04-11,2023-04-10,2023-04-10,"Medaljer","Bg-bet. via internet",-32650.00,230743.05
8,83139,0742551138,"Placerkto Företag",SEK,2023-08-03,2023-08-03,2023-08-03,"831395241997070","Överföring via internet",-100000.00,130743.05
9,83139,0742551138,"Placerkto Företag",SEK,2023-08-22,2023-08-22,2023-08-22,"Internöverföring","Överföring via internet",-100000.00,30743.05
