* Transaktionsrapport Period 2023-01-01 – 2023-10-12 Skapad 2023-10-12 15:22 CEST
Radnr,Clnr,Kontonr,Produkt,Valuta,Bokfdag,Transdag,Valutadag,Referens,Text,Belopp,Saldo
1,83139,0741326839,"Företagskonto",SEK,2023-10-11,2023-10-11,2023-10-12,"6428437","Bankgiro inbetalning",2000.00,53638.70
2,83139,0741326839,"Företagskonto",SEK,2023-10-11,2023-10-11,2023-10-11,"Victoriastadion","Bg-bet. via internet",-3300.00,51638.70
3,83139,0741326839,"Företagskonto",SEK,2023-10-11,2023-10-11,2023-10-11,"Jobbmat Stortorg","Överföring via internet",-2200.00,54938.70
4,83139,0741326839,"Företagskonto",SEK,2023-10-10,2023-10-10,2023-10-10,"Utskottsutbildni","Överföring via internet",-480.00,57138.70
5,83139,0741326839,"Företagskonto",SEK,2023-10-10,2023-10-10,2023-10-10,"Bokföringsmat","Överföring via internet",-85.00,57618.70
6,83139,0741326839,"Företagskonto",SEK,2023-10-10,2023-10-10,2023-10-10,"Bocker till HÄS","Överföring via internet",-594.00,57703.70
7,83139,0741326839,"Företagskonto",SEK,2023-10-10,2023-10-10,2023-10-10,"Intervjumat","Överföring via internet",-75.00,58297.70
8,83139,0741326839,"Företagskonto",SEK,2023-10-10,2023-10-10,2023-10-10,"Libu nollningsev","Överföring via internet",-277.20,58372.70
9,83139,0741326839,"Företagskonto",SEK,2023-10-10,2023-10-10,2023-10-10,"Ramar till HÄS","Överföring via internet",-839.00,58649.90
10,83139,0741326839,"Företagskonto",SEK,2023-10-10,2023-10-10,2023-10-10,"Resa till punkte","Överföring via internet",-28.00,59488.90
11,83139,0741326839,"Företagskonto",SEK,2023-10-10,2023-10-10,2023-10-10,"Möss dekoratione","Överföring via internet",-287.79,59516.90
12,83139,0741326839,"Företagskonto",SEK,2023-10-10,2023-10-10,2023-10-10,"Punktering","Överföring via internet",-400.00,59804.69
13,83139,0741326839,"Företagskonto",SEK,2023-10-10,2023-10-10,2023-10-10,"Intervjumat","Överföring via internet",-325.00,60204.69
14,83139,0741326839,"Företagskonto",SEK,2023-10-10,2023-10-10,2023-10-10,"Bokföringsmat","Överföring via internet",-56.80,60529.69
15,83139,0741326839,"Företagskonto",SEK,2023-10-10,2023-10-10,2023-10-10,"ValleB tack","Överföring via internet",-280.00,60586.49
16,83139,0741326839,"Företagskonto",SEK,2023-10-10,2023-10-10,2023-10-10,"Tygg","Överföring via internet",-185.30,60866.49
17,83139,0741326839,"Företagskonto",SEK,2023-10-10,2023-10-10,2023-10-10,"Oljefat + Däckme","Överföring via internet",-379.00,61051.79
18,83139,0741326839,"Företagskonto",SEK,2023-10-10,2023-10-10,2023-10-10,"Hjälmar","Överföring via internet",-507.00,61430.79
19,83139,0741326839,"Företagskonto",SEK,2023-10-10,2023-10-10,2023-10-10,"Fogskum","Överföring via internet",-119.80,61937.79
20,83139,0741326839,"Företagskonto",SEK,2023-10-10,2023-10-10,2023-10-10,"Bokföringsmat","Överföring via internet",-85.00,62057.59
21,83139,0741326839,"Företagskonto",SEK,2023-10-10,2023-10-10,2023-10-10,"Ledningsskifte","Överföring via internet",-438.40,62142.59
22,83139,0741326839,"Företagskonto",SEK,2023-10-10,2023-10-10,2023-10-10,"Valle b skifte","Överföring via internet",-428.95,62580.99
23,83139,0741326839,"Företagskonto",SEK,2023-10-10,2023-10-10,2023-10-10,"Kaffe varvning","Överföring via internet",-231.70,63009.94
24,83139,0741326839,"Företagskonto",SEK,2023-10-10,2023-10-10,2023-10-10,"Material libu","Överföring via internet",-781.90,63241.64
25,83139,0741326839,"Företagskonto",SEK,2023-10-09,2023-10-09,2023-10-10,"6428437","Bankgiro inbetalning",300.00,64023.54
26,83139,0741326839,"Företagskonto",SEK,2023-10-09,2023-10-09,2023-10-09,"Blombukett","Överföring via internet",-149.00,63723.54
27,83139,0741326839,"Företagskonto",SEK,2023-10-09,2023-10-08,2023-10-08,"Stortorg Bil","Bg-bet. via internet",-2190.00,63872.54
28,83139,0741326839,"Företagskonto",SEK,2023-10-09,2023-10-07,2023-10-07,"Engångsartiklar","Bg-bet. via internet",-2067.00,66062.54
29,83139,0741326839,"Företagskonto",SEK,2023-10-09,2023-10-07,2023-10-07,"Nya Skåp","Bg-bet. via internet",-43775.00,68129.54
30,83139,0741326839,"Företagskonto",SEK,2023-10-09,2023-10-07,2023-10-07,"Parkering Tour d","Bg-bet. via internet",-79.00,111904.54
31,83139,0741326839,"Företagskonto",SEK,2023-10-09,2023-10-07,2023-10-07,"Gasque Hyra WTF","Bg-bet. via internet",-30395.00,111983.54
32,83139,0741326839,"Företagskonto",SEK,2023-10-09,2023-10-07,2023-10-07,"Försäkring Dröna","Bg-bet. via internet",-1400.00,142378.54
33,83139,0741326839,"Företagskonto",SEK,2023-10-09,2023-10-07,2023-10-07,"Pingisnät","Pg-bet. via internet",-678.00,143778.54
34,83139,0741326839,"Företagskonto",SEK,2023-10-09,2023-10-07,2023-10-07,"Pingisbollar","Pg-bet. via internet",-748.00,144456.54
35,83139,0741326839,"Företagskonto",SEK,2023-10-06,2023-10-06,2023-10-09,"6428437","Bankgiro inbetalning",1764.00,145204.54
36,83139,0741326839,"Företagskonto",SEK,2023-10-05,2023-10-05,2023-10-06,"6428437","Bankgiro inbetalning",7000.00,143440.54
37,83139,0741326839,"Företagskonto",SEK,2023-10-03,2023-10-03,2023-10-03,"Stortorg Glas","Överföring via internet",-59.80,136440.54
38,83139,0741326839,"Företagskonto",SEK,2023-10-03,2023-10-03,2023-10-03,"Stortorg Matpref","Överföring via internet",-19.90,136500.34
39,83139,0741326839,"Företagskonto",SEK,2023-10-03,2023-10-03,2023-10-03,"Stortorg Glas","Överföring via internet",-1557.80,136520.24
40,83139,0741326839,"Företagskonto",SEK,2023-10-03,2023-10-03,2023-10-03,"Föset Outfit","Överföring via internet",-126.00,138078.04
41,83139,0741326839,"Företagskonto",SEK,2023-10-03,2023-10-03,2023-10-03,"Stortorg Mat","Överföring via internet",-171.92,138204.04
42,83139,0741326839,"Företagskonto",SEK,2023-10-03,2023-10-03,2023-10-03,"Stortorg Folie","Överföring via internet",-113.60,138375.96
43,83139,0741326839,"Företagskonto",SEK,2023-10-03,2023-10-03,2023-10-03,"Stortorg Städ","Överföring via internet",-49.80,138489.56
44,83139,0741326839,"Företagskonto",SEK,2023-10-03,2023-10-03,2023-10-03,"Uppdragskväll","Överföring via internet",-176.00,138539.36
45,83139,0741326839,"Företagskonto",SEK,2023-10-03,2023-10-03,2023-10-03,"Föset Outfit","Överföring via internet",-179.80,138715.36
46,83139,0741326839,"Företagskonto",SEK,2023-10-03,2023-10-03,2023-10-03,"Föset Outfit","Överföring via internet",-179.95,138895.16
47,83139,0741326839,"Företagskonto",SEK,2023-10-03,2023-10-03,2023-10-03,"Regattan Outfit","Överföring via internet",-330.00,139075.11
48,83139,0741326839,"Företagskonto",SEK,2023-10-03,2023-10-03,2023-10-03,"Stortorg Band","Överföring via internet",-139.70,139405.11
49,83139,0741326839,"Företagskonto",SEK,2023-10-03,2023-10-03,2023-10-03,"Föset Outfit","Överföring via internet",-408.00,139544.81
50,83139,0741326839,"Företagskonto",SEK,2023-09-29,2023-09-29,2023-10-02,"6428437","Bankgiro inbetalning",5250.00,139952.81
51,83139,0741326839,"Företagskonto",SEK,2023-09-29,2023-09-29,2023-09-29,"Wermlands","Bg-bet. via internet",-21220.00,134702.81
52,83139,0741326839,"Företagskonto",SEK,2023-09-29,2023-09-29,2023-09-29,"Märken Nollesex","Bg-bet. via internet",-2056.00,155922.81
53,83139,0741326839,"Företagskonto",SEK,2023-09-29,2023-09-29,2023-09-29,"Faddergruppsmat","Överföring via internet",-466.55,157978.81
54,83139,0741326839,"Företagskonto",SEK,2023-09-29,2023-09-29,2023-09-29,"Campet lampa","Överföring via internet",-199.90,158445.36
55,83139,0741326839,"Företagskonto",SEK,2023-09-29,2023-09-29,2023-09-29,"Nollesex jobbarm","Överföring via internet",-2470.00,158645.26
56,83139,0741326839,"Företagskonto",SEK,2023-09-29,2023-09-29,2023-09-29,"83139741326862","Överföring via internet",14420.38,161115.26
57,83139,0741326839,"Företagskonto",SEK,2023-09-29,2023-09-29,2023-09-29,"Mötesfika","Överföring via internet",-162.90,146694.88
58,83139,0741326839,"Företagskonto",SEK,2023-09-29,2023-09-29,2023-09-29,"Nollesex komp","Överföring via internet",-332.00,146857.78
59,83139,0741326839,"Företagskonto",SEK,2023-09-29,2023-09-29,2023-09-29,"Nollympiaden","Överföring via internet",-264.70,147189.78
60,83139,0741326839,"Företagskonto",SEK,2023-09-29,2023-09-29,2023-09-29,"Nollesex komp","Överföring via internet",-235.90,147454.48
61,83139,0741326839,"Företagskonto",SEK,2023-09-27,2023-09-27,2023-09-28,"6428437","Bankgiro inbetalning",359.00,147690.38
62,83139,0741326839,"Företagskonto",SEK,2023-09-25,2023-09-25,2023-09-26,"6428437","Bankgiro inbetalning",80.00,147331.38
63,83139,0741326839,"Företagskonto",SEK,2023-09-25,2023-09-25,2023-09-25,"Sponsring A sekt","Bg-bet. via internet",-5000.00,147251.38
64,83139,0741326839,"Företagskonto",SEK,2023-09-25,2023-09-25,2023-09-25,"skadogörelse A s","Bg-bet. via internet",-350.00,152251.38
65,83139,0741326839,"Företagskonto",SEK,2023-09-25,2023-09-25,2023-09-25,"Merch inköp","Bg-bet. via internet",-141.00,152601.38
66,83139,0741326839,"Företagskonto",SEK,2023-09-25,2023-09-25,2023-09-25,"Aspia","Bg-bet. via internet",-4306.25,152742.38
67,83139,0741326839,"Företagskonto",SEK,2023-09-25,2023-09-25,2023-09-25,"HÄS Presentkort","Överföring via internet",-4550.00,157048.63
68,83139,0741326839,"Företagskonto",SEK,2023-09-21,2023-09-21,2023-09-21,"83139741326862","Överföring via internet",-8000.00,161598.63
69,83139,0741326839,"Företagskonto",SEK,2023-09-19,2023-09-19,2023-09-20,"6428437","Bankgiro inbetalning",275.00,169598.63
70,83139,0741326839,"Företagskonto",SEK,2023-09-19,2023-09-19,2023-09-19,"83139741326862","Överföring via internet",-15000.00,169323.63
71,83139,0741326839,"Företagskonto",SEK,2023-09-19,2023-09-19,2023-09-19,"83139741326862","Överföring via internet",-30000.00,184323.63
72,83139,0741326839,"Företagskonto",SEK,2023-09-19,2023-09-19,2023-09-19,"Faddergruppsmat","Överföring via internet",-775.00,214323.63
73,83139,0741326839,"Företagskonto",SEK,2023-09-19,2023-09-19,2023-09-19,"Internöverföring","Överföring via internet",200000.00,215098.63
74,83139,0741326839,"Företagskonto",SEK,2023-09-12,2023-09-12,2023-09-13,"6428437","Bankgiro inbetalning",75.00,15098.63
75,83139,0741326839,"Företagskonto",SEK,2023-09-12,2023-09-12,2023-09-12,"Mantelbrodyr","Bg-bet. via internet",-3413.00,15023.63
76,83139,0741326839,"Företagskonto",SEK,2023-09-12,2023-09-12,2023-09-12,"FlyING bussar","Bg-bet. via internet",-7371.00,18436.63
77,83139,0741326839,"Företagskonto",SEK,2023-09-12,2023-09-12,2023-09-12,"Sonnarp","Pg-bet. via internet",-19725.00,25807.63
78,83139,0741326839,"Företagskonto",SEK,2023-09-11,2023-09-11,2023-09-12,"6428437","Bankgiro inbetalning",20325.00,45532.63
79,83139,0741326839,"Företagskonto",SEK,2023-09-11,2023-09-11,2023-09-11,"Märken","Bg-bet. via internet",-9403.00,25207.63
80,83139,0741326839,"Företagskonto",SEK,2023-09-11,2023-09-11,2023-09-11,"Hemsidaavgift","Bg-bet. via internet",-485.00,34610.63
81,83139,0741326839,"Företagskonto",SEK,2023-09-11,2023-09-11,2023-09-11,"Utefotboll","Pg-bet. via internet",-1800.00,35095.63
82,83139,0741326839,"Företagskonto",SEK,2023-09-11,2023-09-11,2023-09-11,"Innefotboll","Pg-bet. via internet",-1800.00,36895.63
83,83139,0741326839,"Företagskonto",SEK,2023-09-11,2023-09-11,2023-09-11,"Milersättning","Överföring via internet",-1325.00,38695.63
84,83139,0741326839,"Företagskonto",SEK,2023-09-11,2023-09-11,2023-09-11,"FlyING Tågresa","Överföring via internet",-87.75,40020.63
85,83139,0741326839,"Företagskonto",SEK,2023-09-11,2023-09-11,2023-09-11,"SING Jobbarmat","Överföring via internet",-125.00,40108.38
86,83139,0741326839,"Företagskonto",SEK,2023-09-11,2023-09-11,2023-09-11,"SING Komp-handli","Överföring via internet",-119.50,40233.38
87,83139,0741326839,"Företagskonto",SEK,2023-09-11,2023-09-11,2023-09-11,"Faddergruppsmat","Överföring via internet",-581.73,40352.88
88,83139,0741326839,"Företagskonto",SEK,2023-09-11,2023-09-11,2023-09-11,"Cykel hyra TDL","Överföring via internet",-1800.00,40934.61
89,83139,0741326839,"Företagskonto",SEK,2023-09-11,2023-09-11,2023-09-11,"SING Komp-handli","Överföring via internet",-414.30,42734.61
90,83139,0741326839,"Företagskonto",SEK,2023-09-11,2023-09-11,2023-09-11,"Tour de lomma","Överföring via internet",-99.90,43148.91
91,83139,0741326839,"Företagskonto",SEK,2023-09-11,2023-09-11,2023-09-11,"Färg","Överföring via internet",-418.00,43248.81
92,83139,0741326839,"Företagskonto",SEK,2023-09-11,2023-09-11,2023-09-11,"SING Jobbarmat","Överföring via internet",-1145.00,43666.81
93,83139,0741326839,"Företagskonto",SEK,2023-09-11,2023-09-11,2023-09-11,"Milersättning","Överföring via internet",-550.00,44811.81
94,83139,0741326839,"Företagskonto",SEK,2023-09-11,2023-09-11,2023-09-11,"Färg","Överföring via internet",-2312.00,45361.81
95,83139,0741326839,"Företagskonto",SEK,2023-09-11,2023-09-11,2023-09-11,"Ovvelekar Grillk","Överföring via internet",-199.50,47673.81
96,83139,0741326839,"Företagskonto",SEK,2023-09-11,2023-09-11,2023-09-11,"Faddergruppsmat","Överföring via internet",-575.00,47873.31
97,83139,0741326839,"Företagskonto",SEK,2023-09-11,2023-09-11,2023-09-11,"SING Jobbarmat","Överföring via internet",-47.70,48448.31
98,83139,0741326839,"Företagskonto",SEK,2023-09-11,2023-09-11,2023-09-11,"Föset Outfit","Överföring via internet",-129.00,48496.01
99,83139,0741326839,"Företagskonto",SEK,2023-09-11,2023-09-11,2023-09-11,"Faddergruppsmat","Överföring via internet",-488.38,48625.01
100,83139,0741326839,"Företagskonto",SEK,2023-09-08,2023-09-08,2023-09-11,"6428437","Bankgiro inbetalning",1000.00,49113.39
101,83139,0741326839,"Företagskonto",SEK,2023-09-06,2023-09-06,2023-09-07,"6428437","Bankgiro inbetalning",33000.00,48113.39
102,83139,0741326839,"Företagskonto",SEK,2023-09-06,2023-09-06,2023-09-06,"Halloween-märke","Bg-bet. via internet",-2540.00,15113.39
103,83139,0741326839,"Företagskonto",SEK,2023-09-06,2023-09-06,2023-09-06,"Planhyra","Överföring via internet",-450.00,17653.39
104,83139,0741326839,"Företagskonto",SEK,2023-09-06,2023-09-06,2023-09-06,"Valle B Tack","Överföring via internet",-620.00,18103.39
105,83139,0741326839,"Företagskonto",SEK,2023-09-06,2023-09-06,2023-09-06,"Skiftes buss","Överföring via internet",-438.40,18723.39
106,83139,0741326839,"Företagskonto",SEK,2023-09-06,2023-09-06,2023-09-06,"Arbetskläder","Överföring via internet",-248.00,19161.79
107,83139,0741326839,"Företagskonto",SEK,2023-09-06,2023-09-06,2023-09-06,"Milersättning","Överföring via internet",-1325.00,19409.79
108,83139,0741326839,"Företagskonto",SEK,2023-09-06,2023-09-06,2023-09-06,"Mat","Överföring via internet",-211.50,20734.79
109,83139,0741326839,"Företagskonto",SEK,2023-09-06,2023-09-06,2023-09-06,"Styrelseutbildni","Överföring via internet",-680.00,20946.29
110,83139,0741326839,"Företagskonto",SEK,2023-09-06,2023-09-06,2023-09-06,"Skiftes buss","Överföring via internet",-175.50,21626.29
111,83139,0741326839,"Företagskonto",SEK,2023-09-06,2023-09-06,2023-09-06,"Diesel","Överföring via internet",-1122.39,21801.79
112,83139,0741326839,"Företagskonto",SEK,2023-09-06,2023-09-06,2023-09-06,"Milersättning","Överföring via internet",-500.00,22924.18
113,83139,0741326839,"Företagskonto",SEK,2023-09-06,2023-09-06,2023-09-06,"Gyckel","Överföring via internet",-790.00,23424.18
114,83139,0741326839,"Företagskonto",SEK,2023-09-05,2023-09-05,2023-09-06,"6428437","Bankgiro inbetalning",740.00,24214.18
115,83139,0741326839,"Företagskonto",SEK,2023-09-05,2023-09-05,2023-09-05,"Inköp Inventarie","Överföring via internet",-1824.30,23474.18
116,83139,0741326839,"Företagskonto",SEK,2023-09-05,2023-09-05,2023-09-05,"Skiftes buss","Överföring via internet",-438.40,25298.48
117,83139,0741326839,"Företagskonto",SEK,2023-09-05,2023-09-05,2023-09-05,"Tack Valleb","Överföring via internet",-650.00,25736.88
118,83139,0741326839,"Företagskonto",SEK,2023-09-05,2023-09-05,2023-09-05,"Skifte mat","Överföring via internet",-375.00,26386.88
119,83139,0741326839,"Företagskonto",SEK,2023-09-05,2023-09-05,2023-09-05,"Första hjälpen","Överföring via internet",-296.00,26761.88
120,83139,0741326839,"Företagskonto",SEK,2023-09-05,2023-09-05,2023-09-05,"Deisel","Överföring via internet",-1168.37,27057.88
121,83139,0741326839,"Företagskonto",SEK,2023-09-05,2023-09-05,2023-09-05,"Skiftes buss","Överföring via internet",-438.00,28226.25
122,83139,0741326839,"Företagskonto",SEK,2023-09-05,2023-09-05,2023-09-05,"Skiftes buss","Överföring via internet",-438.40,28664.25
123,83139,0741326839,"Företagskonto",SEK,2023-09-05,2023-09-05,2023-09-05,"Inventarie","Överföring via internet",-1595.00,29102.65
124,83139,0741326839,"Företagskonto",SEK,2023-09-05,2023-09-05,2023-09-05,"Byggmaterial Nol","Överföring via internet",-1003.65,30697.65
125,83139,0741326839,"Företagskonto",SEK,2023-09-05,2023-09-05,2023-09-05,"Biltvätt","Överföring via internet",-69.28,31701.30
126,83139,0741326839,"Företagskonto",SEK,2023-09-05,2023-09-05,2023-09-05,"Biltvätt","Överföring via internet",-34.72,31770.58
127,83139,0741326839,"Företagskonto",SEK,2023-09-05,2023-09-05,2023-09-05,"Inköp Biltema","Överföring via internet",-274.50,31805.30
128,83139,0741326839,"Företagskonto",SEK,2023-09-05,2023-09-05,2023-09-05,"Skifte Middag","Överföring via internet",-3319.00,32079.80
129,83139,0741326839,"Företagskonto",SEK,2023-09-05,2023-09-05,2023-09-05,"Rengöring","Överföring via internet",-99.90,35398.80
130,83139,0741326839,"Företagskonto",SEK,2023-09-05,2023-09-05,2023-09-05,"Skiftes buss","Överföring via internet",-438.40,35498.70
131,83139,0741326839,"Företagskonto",SEK,2023-09-05,2023-09-05,2023-09-05,"Nano Heltid","Överföring via internet",-500.00,35937.10
132,83139,0741326839,"Företagskonto",SEK,2023-09-05,2023-09-05,2023-09-05,"Byggmaterial","Överföring via internet",-807.40,36437.10
133,83139,0741326839,"Företagskonto",SEK,2023-09-05,2023-09-05,2023-09-05,"Skifte Fika","Överföring via internet",-249.20,37244.50
134,83139,0741326839,"Företagskonto",SEK,2023-09-04,2023-09-03,2023-09-03,"Faddergruppsmat","Överföring via internet",-700.00,37493.70
135,83139,0741326839,"Företagskonto",SEK,2023-09-04,2023-09-03,2023-09-03,"Camp Frukost","Överföring via internet",-27.80,38193.70
136,83139,0741326839,"Företagskonto",SEK,2023-09-04,2023-09-03,2023-09-03,"Camp Blandat","Överföring via internet",-374.40,38221.50
137,83139,0741326839,"Företagskonto",SEK,2023-09-04,2023-09-03,2023-09-03,"Faddergruppsmat","Överföring via internet",-515.24,38595.90
138,83139,0741326839,"Företagskonto",SEK,2023-09-04,2023-09-03,2023-09-03,"Faddergruppsmat","Överföring via internet",-434.04,39111.14
139,83139,0741326839,"Företagskonto",SEK,2023-09-04,2023-09-03,2023-09-03,"Camp Städning","Överföring via internet",-125.60,39545.18
140,83139,0741326839,"Företagskonto",SEK,2023-09-04,2023-09-03,2023-09-03,"Camp Jobbargodis","Överföring via internet",-141.00,39670.78
141,83139,0741326839,"Företagskonto",SEK,2023-09-04,2023-09-03,2023-09-03,"Camp Batterier","Överföring via internet",-134.80,39811.78
142,83139,0741326839,"Företagskonto",SEK,2023-09-04,2023-09-03,2023-09-03,"Marschaller","Överföring via internet",-497.30,39946.58
143,83139,0741326839,"Företagskonto",SEK,2023-09-04,2023-09-03,2023-09-03,"Ved","Överföring via internet",-899.10,40443.88
144,83139,0741326839,"Företagskonto",SEK,2023-09-04,2023-09-03,2023-09-03,"Faddergruppsmat","Överföring via internet",-504.00,41342.98
145,83139,0741326839,"Företagskonto",SEK,2023-09-04,2023-09-03,2023-09-03,"Faddergruppsmat","Överföring via internet",-548.04,41846.98
146,83139,0741326839,"Företagskonto",SEK,2023-09-04,2023-09-03,2023-09-03,"Faddergruppsmat","Överföring via internet",-85.60,42395.02
147,83139,0741326839,"Företagskonto",SEK,2023-09-04,2023-09-03,2023-09-03,"Material","Överföring via internet",-105.00,42480.62
148,83139,0741326839,"Företagskonto",SEK,2023-09-04,2023-09-03,2023-09-03,"Faddergruppsmat","Överföring via internet",-493.20,42585.62
149,83139,0741326839,"Företagskonto",SEK,2023-09-04,2023-09-03,2023-09-03,"Faddergruppsmat","Överföring via internet",-77.90,43078.82
150,83139,0741326839,"Företagskonto",SEK,2023-09-04,2023-09-03,2023-09-03,"Faddergruppsmat","Överföring via internet",-118.91,43156.72
151,83139,0741326839,"Företagskonto",SEK,2023-09-04,2023-09-03,2023-09-03,"Camp Drivmedel","Överföring via internet",-279.00,43275.63
152,83139,0741326839,"Företagskonto",SEK,2023-08-31,2023-08-31,2023-08-30,"Busscampet","Bg-bet. via internet",-43245.00,43554.63
153,83139,0741326839,"Företagskonto",SEK,2023-08-31,2023-08-31,2023-08-30,"Lednings Brodyr","Bg-bet. via internet",-4275.00,86799.63
154,83139,0741326839,"Företagskonto",SEK,2023-08-31,2023-08-31,2023-08-30,"Brodyr","Bg-bet. via internet",-1893.75,91074.63
155,83139,0741326839,"Företagskonto",SEK,2023-08-31,2023-08-31,2023-08-30,"Tryckerikostnade","Bg-bet. via internet",-2470.00,92968.38
156,83139,0741326839,"Företagskonto",SEK,2023-08-31,2023-08-31,2023-08-30,"Faddergruppsmat","Överföring via internet",-550.00,95438.38
157,83139,0741326839,"Företagskonto",SEK,2023-08-31,2023-08-31,2023-08-30,"Faddergruppsmat","Överföring via internet",-627.00,95988.38
158,83139,0741326839,"Företagskonto",SEK,2023-08-30,2023-08-30,2023-09-01,"6428437","Bankgiro inbetalning",150.00,96615.38
159,83139,0741326839,"Företagskonto",SEK,2023-08-30,2023-08-30,2023-08-30,"Engångsartiklar","Bg-bet. via internet",-5846.00,96465.38
160,83139,0741326839,"Företagskonto",SEK,2023-08-30,2023-08-30,2023-08-30,"Campetmat","Överföring via internet",-179.00,102311.38
161,83139,0741326839,"Företagskonto",SEK,2023-08-30,2023-08-30,2023-08-30,"83139741326847","Överföring via internet",100000.00,102490.38
162,83139,0741326839,"Företagskonto",SEK,2023-08-30,2023-08-30,2023-08-30,"Jobbarmat","Överföring via internet",-37.80,2490.38
163,83139,0741326839,"Företagskonto",SEK,2023-08-30,2023-08-30,2023-08-30,"Jobbarsnacks","Överföring via internet",-1575.04,2528.18
164,83139,0741326839,"Företagskonto",SEK,2023-08-30,2023-08-30,2023-08-30,"Faddergruppsmat","Överföring via internet",-131.94,4103.22
165,83139,0741326839,"Företagskonto",SEK,2023-08-30,2023-08-30,2023-08-30,"Campetmat","Överföring via internet",-89.00,4235.16
166,83139,0741326839,"Företagskonto",SEK,2023-08-30,2023-08-30,2023-08-30,"Jobbargodis","Överföring via internet",-190.15,4324.16
167,83139,0741326839,"Företagskonto",SEK,2023-08-30,2023-08-30,2023-08-30,"Faddergruppsmat","Överföring via internet",-550.00,4514.31
168,83139,0741326839,"Företagskonto",SEK,2023-08-30,2023-08-30,2023-08-30,"Faddergruppsmat","Överföring via internet",-418.06,5064.31
169,83139,0741326839,"Företagskonto",SEK,2023-08-30,2023-08-30,2023-08-30,"Campetmat","Överföring via internet",-449.90,5482.37
170,83139,0741326839,"Företagskonto",SEK,2023-08-29,2023-08-29,2023-08-29,"Faddergruppsmat","Överföring via internet",-374.94,5932.27
171,83139,0741326839,"Företagskonto",SEK,2023-08-29,2023-08-29,2023-08-29,"83139741326862","Överföring via internet",-26000.00,6307.21
172,83139,0741326839,"Företagskonto",SEK,2023-08-28,2023-08-28,2023-08-28,"Faddergruppsmat","Överföring via internet",-81.70,32307.21
173,83139,0741326839,"Företagskonto",SEK,2023-08-28,2023-08-28,2023-08-28,"Faddergruppsmat","Överföring via internet",-350.00,32388.91
174,83139,0741326839,"Företagskonto",SEK,2023-08-28,2023-08-28,2023-08-28,"Faddergruppsmat","Överföring via internet",-475.00,32738.91
175,83139,0741326839,"Företagskonto",SEK,2023-08-28,2023-08-27,2023-08-27,"83139741326862","Överföring via internet",-5000.00,33213.91
176,83139,0741326839,"Företagskonto",SEK,2023-08-23,2023-08-23,2023-08-23,"Domänkostnad","Bg-bet. via internet",-120.00,38213.91
177,83139,0741326839,"Företagskonto",SEK,2023-08-23,2023-08-23,2023-08-23,"Skumbollar","Bg-bet. via internet",-931.86,38333.91
178,83139,0741326839,"Företagskonto",SEK,2023-08-23,2023-08-23,2023-08-23,"Banhyra","Bg-bet. via internet",-3900.00,39265.77
179,83139,0741326839,"Företagskonto",SEK,2023-08-23,2023-08-23,2023-08-23,"Banbetalning","Bg-bet. via internet",-7800.00,43165.77
180,83139,0741326839,"Företagskonto",SEK,2023-08-23,2023-08-23,2023-08-23,"Faddergruppsmat","Överföring via internet",-159.80,50965.77
181,83139,0741326839,"Företagskonto",SEK,2023-08-23,2023-08-23,2023-08-23,"Faddergruppsmat","Överföring via internet",-530.52,51125.57
182,83139,0741326839,"Företagskonto",SEK,2023-08-23,2023-08-23,2023-08-23,"Faddergruppsmat","Överföring via internet",-574.22,51656.09
183,83139,0741326839,"Företagskonto",SEK,2023-08-23,2023-08-23,2023-08-23,"Faddergruppsmat","Överföring via internet",-550.00,52230.31
184,83139,0741326839,"Företagskonto",SEK,2023-08-23,2023-08-23,2023-08-23,"Faddergruppsmat","Överföring via internet",-390.45,52780.31
185,83139,0741326839,"Företagskonto",SEK,2023-08-23,2023-08-23,2023-08-23,"Kol Utskottssafa","Överföring via internet",-211.60,53170.76
186,83139,0741326839,"Företagskonto",SEK,2023-08-22,2023-08-22,2023-08-22,"83139741326862","Överföring via internet",-45000.00,53382.36
187,83139,0741326839,"Företagskonto",SEK,2023-08-22,2023-08-22,2023-08-22,"83139741326870","Överföring via internet",-10000.00,98382.36
188,83139,0741326839,"Företagskonto",SEK,2023-08-22,2023-08-22,2023-08-22,"Faddergruppsmat","Överföring via internet",-550.00,108382.36
189,83139,0741326839,"Företagskonto",SEK,2023-08-22,2023-08-22,2023-08-22,"Internöverföring","Överföring via internet",100000.00,108932.36
190,83139,0741326839,"Företagskonto",SEK,2023-08-21,2023-08-20,2023-08-20,"Märken Nollning","Bg-bet. via internet",-17182.00,8932.36
191,83139,0741326839,"Företagskonto",SEK,2023-08-21,2023-08-19,2023-08-19,"Pompoms (tull)","Överföring via internet",-467.00,26114.36
192,83139,0741326839,"Företagskonto",SEK,2023-08-21,2023-08-19,2023-08-19,"Outfit","Överföring via internet",-81.95,26581.36
193,83139,0741326839,"Företagskonto",SEK,2023-08-21,2023-08-19,2023-08-19,"Outfit","Överföring via internet",-240.75,26663.31
194,83139,0741326839,"Företagskonto",SEK,2023-08-21,2023-08-19,2023-08-19,"Outfit","Överföring via internet",-379.54,26904.06
195,83139,0741326839,"Företagskonto",SEK,2023-08-21,2023-08-19,2023-08-19,"Outfit","Överföring via internet",-188.60,27283.60
196,83139,0741326839,"Företagskonto",SEK,2023-08-21,2023-08-19,2023-08-19,"Adobe-konto","Överföring via internet",-2328.30,27472.20
197,83139,0741326839,"Företagskonto",SEK,2023-08-21,2023-08-19,2023-08-19,"Outfit","Överföring via internet",-101.80,29800.50
198,83139,0741326839,"Företagskonto",SEK,2023-08-21,2023-08-19,2023-08-19,"Tyg","Överföring via internet",-66.00,29902.30
199,83139,0741326839,"Företagskonto",SEK,2023-08-21,2023-08-19,2023-08-19,"Mötesmat Föset","Överföring via internet",-85.00,29968.30
200,83139,0741326839,"Företagskonto",SEK,2023-08-21,2023-08-19,2023-08-19,"Outfit","Överföring via internet",-138.13,30053.30
201,83139,0741326839,"Företagskonto",SEK,2023-08-21,2023-08-19,2023-08-19,"Outfit","Överföring via internet",-19.00,30191.43
202,83139,0741326839,"Företagskonto",SEK,2023-08-21,2023-08-19,2023-08-19,"Outfit","Överföring via internet",-156.97,30210.43
203,83139,0741326839,"Företagskonto",SEK,2023-08-21,2023-08-19,2023-08-19,"Outfit","Överföring via internet",-118.00,30367.40
204,83139,0741326839,"Företagskonto",SEK,2023-08-21,2023-08-19,2023-08-19,"Outfit","Överföring via internet",-687.00,30485.40
205,83139,0741326839,"Företagskonto",SEK,2023-08-21,2023-08-19,2023-08-19,"Outfit","Överföring via internet",-122.20,31172.40
206,83139,0741326839,"Företagskonto",SEK,2023-08-21,2023-08-19,2023-08-19,"Outfit","Överföring via internet",-155.00,31294.60
207,83139,0741326839,"Företagskonto",SEK,2023-08-21,2023-08-19,2023-08-19,"Mötesmat Föset","Överföring via internet",-85.00,31449.60
208,83139,0741326839,"Företagskonto",SEK,2023-08-21,2023-08-19,2023-08-19,"Outfit","Överföring via internet",-248.08,31534.60
209,83139,0741326839,"Företagskonto",SEK,2023-08-21,2023-08-19,2023-08-19,"Outfit","Överföring via internet",-151.20,31782.68
210,83139,0741326839,"Företagskonto",SEK,2023-08-21,2023-08-19,2023-08-19,"Outfit","Överföring via internet",-61.20,31933.88
211,83139,0741326839,"Företagskonto",SEK,2023-08-21,2023-08-19,2023-08-19,"Outfit","Överföring via internet",-345.39,31995.08
212,83139,0741326839,"Företagskonto",SEK,2023-08-21,2023-08-19,2023-08-19,"Outfit","Överföring via internet",-59.38,32340.47
213,83139,0741326839,"Företagskonto",SEK,2023-08-21,2023-08-19,2023-08-19,"Outfit","Överföring via internet",-129.90,32399.85
214,83139,0741326839,"Företagskonto",SEK,2023-08-18,2023-08-18,2023-08-21,"6428437","Bankgiro inbetalning",4500.00,32529.75
215,83139,0741326839,"Företagskonto",SEK,2023-08-17,2023-08-16,2023-08-16,"83139741326862","Överföring via internet",-5000.00,28029.75
216,83139,0741326839,"Företagskonto",SEK,2023-08-16,2023-08-16,2023-08-16,"83139741326862","Överföring via internet",-22000.00,33029.75
217,83139,0741326839,"Företagskonto",SEK,2023-08-15,2023-08-15,2023-08-16,"6428437","Bankgiro inbetalning",580.00,55029.75
218,83139,0741326839,"Företagskonto",SEK,2023-08-14,2023-08-14,2023-08-15,"6428437","Bankgiro inbetalning",400.00,54449.75
219,83139,0741326839,"Företagskonto",SEK,2023-08-14,2023-08-13,2023-08-13,"83139741326862","Överföring via internet",-210.00,54049.75
220,83139,0741326839,"Företagskonto",SEK,2023-08-11,2023-08-11,2023-08-14,"6428437","Bankgiro inbetalning",1300.00,54259.75
221,83139,0741326839,"Företagskonto",SEK,2023-08-11,2023-08-11,2023-08-11,"Bilförsäkring","Bg-bet. via internet",-1985.00,52959.75
222,83139,0741326839,"Företagskonto",SEK,2023-08-11,2023-08-11,2023-08-11,"Datorryggsäkar F","Bg-bet. via internet",-81046.25,54944.75
223,83139,0741326839,"Företagskonto",SEK,2023-08-11,2023-08-11,2023-08-11,"Drönarkörkortsko","Bg-bet. via internet",-135.00,135991.00
224,83139,0741326839,"Företagskonto",SEK,2023-08-11,2023-08-11,2023-08-11,"Fordonskatt","Bg-bet. via internet",-1671.00,136126.00
225,83139,0741326839,"Företagskonto",SEK,2023-08-11,2023-08-11,2023-08-11,"Bokföringsmat","Överföring via internet",-77.00,137797.00
226,83139,0741326839,"Företagskonto",SEK,2023-08-11,2023-08-11,2023-08-11,"Arbetskläder + A","Överföring via internet",-660.70,137874.00
227,83139,0741326839,"Företagskonto",SEK,2023-08-10,2023-08-10,2023-08-11,"6428437","Bankgiro inbetalning",1000.00,138534.70
228,83139,0741326839,"Företagskonto",SEK,2023-08-10,2023-08-10,2023-08-10,"Uteblivennärvaro","Bg-bet. via internet",-400.00,137534.70
229,83139,0741326839,"Företagskonto",SEK,2023-08-10,2023-08-10,2023-08-10,"Skvalborg Teknik","Bg-bet. via internet",-1590.00,137934.70
230,83139,0741326839,"Företagskonto",SEK,2023-08-10,2023-08-10,2023-08-10,"Tandembiljetter","Bg-bet. via internet",-44550.00,139524.70
231,83139,0741326839,"Företagskonto",SEK,2023-08-10,2023-08-10,2023-08-10,"Alumnipup","Bg-bet. via internet",-2705.00,184074.70
232,83139,0741326839,"Företagskonto",SEK,2023-08-10,2023-08-10,2023-08-10,"Sångböcker","Bg-bet. via internet",-31630.00,186779.70
233,83139,0741326839,"Företagskonto",SEK,2023-08-10,2023-08-10,2023-08-10,"Revisormat","Överföring via internet",-84.70,218409.70
234,83139,0741326839,"Företagskonto",SEK,2023-08-10,2023-08-10,2023-08-10,"Revisormat","Överföring via internet",-170.00,218494.40
235,83139,0741326839,"Företagskonto",SEK,2023-08-10,2023-08-10,2023-08-10,"Heltidssittning","Överföring via internet",-2000.00,218664.40
236,83139,0741326839,"Företagskonto",SEK,2023-08-10,2023-08-10,2023-08-10,"Ceq mat","Överföring via internet",-170.00,220664.40
237,83139,0741326839,"Företagskonto",SEK,2023-08-10,2023-08-10,2023-08-10,"Arbetskläder RM","Överföring via internet",-600.00,220834.40
238,83139,0741326839,"Företagskonto",SEK,2023-08-09,2023-08-09,2023-08-09,"Lophtet Valborg","Bg-bet. via internet",-2915.00,221434.40
239,83139,0741326839,"Företagskonto",SEK,2023-08-08,2023-08-08,2023-08-08,"83139741326847","Överföring via internet",150000.00,224349.40
240,83139,0741326839,"Företagskonto",SEK,2023-07-03,2023-07-03,2023-07-03,"83139741326862","Överföring via internet",-7000.00,74349.40
241,83139,0741326839,"Företagskonto",SEK,2023-06-30,2023-06-30,2023-06-30,"Mat FNU","Bg-bet. via internet",-7780.00,81349.40
242,83139,0741326839,"Företagskonto",SEK,2023-06-30,2023-06-30,2023-06-30,"Ehuset tryckeri","Bg-bet. via internet",-2179.00,89129.40
243,83139,0741326839,"Företagskonto",SEK,2023-06-30,2023-06-30,2023-06-30,"Fotoväg","Bg-bet. via internet",-3586.00,91308.40
244,83139,0741326839,"Företagskonto",SEK,2023-06-30,2023-06-30,2023-06-30,"Paddel","Bg-bet. via internet",-2765.51,94894.40
245,83139,0741326839,"Företagskonto",SEK,2023-06-22,2023-06-22,2023-06-26,"UF bidrag","Överföring",38400.00,97659.91
246,83139,0741326839,"Företagskonto",SEK,2023-06-21,2023-06-21,2023-06-22,"6428437","Bankgiro inbetalning",1250.00,59259.91
247,83139,0741326839,"Företagskonto",SEK,2023-06-16,2023-06-16,2023-06-16,"Reise skifte Lop","Bg-bet. via internet",-1250.00,58009.91
248,83139,0741326839,"Företagskonto",SEK,2023-06-16,2023-06-16,2023-06-16,"Power Banks Tand","Pg-bet. via internet",-1159.80,59259.91
249,83139,0741326839,"Företagskonto",SEK,2023-06-14,2023-06-14,2023-06-15,"6428437","Bankgiro inbetalning",7801.46,60419.71
250,83139,0741326839,"Företagskonto",SEK,2023-06-09,2023-06-09,2023-06-09,"Skor Fös-Outfit","Överföring via internet",-368.50,52618.25
251,83139,0741326839,"Företagskonto",SEK,2023-06-09,2023-06-09,2023-06-09,"Klänning Fös-Out","Överföring via internet",-984.50,52986.75
252,83139,0741326839,"Företagskonto",SEK,2023-06-09,2023-06-09,2023-06-09,"Glasögon Fös-Out","Överföring via internet",-894.00,53971.25
253,83139,0741326839,"Företagskonto",SEK,2023-06-09,2023-06-09,2023-06-09,"Skor Fös-Outfit","Överföring via internet",-283.00,54865.25
254,83139,0741326839,"Företagskonto",SEK,2023-06-09,2023-06-09,2023-06-09,"Skor till Fös-Ou","Överföring via internet",-348.00,55148.25
255,83139,0741326839,"Företagskonto",SEK,2023-06-09,2023-06-09,2023-06-09,"Ringar till Fös-","Överföring via internet",-22.00,55496.25
256,83139,0741326839,"Företagskonto",SEK,2023-06-09,2023-06-09,2023-06-09,"Tiara Fös-Outfit","Överföring via internet",-321.00,55518.25
257,83139,0741326839,"Företagskonto",SEK,2023-06-09,2023-06-09,2023-06-09,"Smycken Fös-Outf","Överföring via internet",-208.00,55839.25
258,83139,0741326839,"Företagskonto",SEK,2023-06-09,2023-06-09,2023-06-09,"Mötesmat Föset","Överföring via internet",-461.31,56047.25
259,83139,0741326839,"Företagskonto",SEK,2023-06-09,2023-06-09,2023-06-09,"Kjol Fös-Outfit","Överföring via internet",-1173.00,56508.56
260,83139,0741326839,"Företagskonto",SEK,2023-06-09,2023-06-09,2023-06-09,"Tyg Mantel Fös-O","Överföring via internet",-42.00,57681.56
261,83139,0741326839,"Företagskonto",SEK,2023-06-09,2023-06-09,2023-06-09,"Halsband till Fö","Överföring via internet",-38.00,57723.56
262,83139,0741326839,"Företagskonto",SEK,2023-06-09,2023-06-09,2023-06-09,"Mötesmat Föset","Överföring via internet",-340.00,57761.56
263,83139,0741326839,"Företagskonto",SEK,2023-06-09,2023-06-09,2023-06-09,"83139741326862","Överföring via internet",13076.39,58101.56
264,83139,0741326839,"Företagskonto",SEK,2023-06-07,2023-06-07,2023-06-08,"6428437","Bankgiro inbetalning",585.00,45025.17
265,83139,0741326839,"Företagskonto",SEK,2023-06-05,2023-06-03,2023-06-03,"83139741326862","Överföring via internet",-20000.00,44440.17
266,83139,0741326839,"Företagskonto",SEK,2023-06-05,2023-06-03,2023-06-03,"Event fika","Överföring via internet",-316.00,64440.17
267,83139,0741326839,"Företagskonto",SEK,2023-06-05,2023-06-03,2023-06-03,"Alumnipub","Överföring via internet",-1726.92,64756.17
268,83139,0741326839,"Företagskonto",SEK,2023-06-05,2023-06-03,2023-06-03,"Mat SRF SRpi","Överföring via internet",-133.00,66483.09
269,83139,0741326839,"Företagskonto",SEK,2023-06-05,2023-06-03,2023-06-03,"Revisormat","Överföring via internet",-85.00,66616.09
270,83139,0741326839,"Företagskonto",SEK,2023-06-05,2023-06-03,2023-06-03,"Event Fika","Överföring via internet",-110.50,66701.09
271,83139,0741326839,"Företagskonto",SEK,2023-06-05,2023-06-03,2023-06-03,"Intervju godis","Överföring via internet",-62.68,66811.59
272,83139,0741326839,"Företagskonto",SEK,2023-06-05,2023-06-03,2023-06-03,"Tandem","Överföring via internet",-89.80,66874.27
273,83139,0741326839,"Företagskonto",SEK,2023-06-05,2023-06-03,2023-06-03,"Vårskål","Överföring via internet",-224.70,66964.07
274,83139,0741326839,"Företagskonto",SEK,2023-06-05,2023-06-03,2023-06-03,"Outfit","Överföring via internet",-178.50,67188.77
275,83139,0741326839,"Företagskonto",SEK,2023-06-05,2023-06-03,2023-06-03,"Klättring","Överföring via internet",-800.00,67367.27
276,83139,0741326839,"Företagskonto",SEK,2023-06-05,2023-06-03,2023-06-03,"Outfit","Överföring via internet",-50.00,68167.27
277,83139,0741326839,"Företagskonto",SEK,2023-06-05,2023-06-03,2023-06-03,"Deisel","Överföring via internet",-393.20,68217.27
278,83139,0741326839,"Företagskonto",SEK,2023-06-05,2023-06-03,2023-06-03,"Outfit","Överföring via internet",-159.90,68610.47
279,83139,0741326839,"Företagskonto",SEK,2023-06-05,2023-06-03,2023-06-03,"Outfit","Överföring via internet",-1869.00,68770.37
280,83139,0741326839,"Företagskonto",SEK,2023-06-05,2023-06-03,2023-06-03,"Intervjumat","Överföring via internet",-164.00,70639.37
281,83139,0741326839,"Företagskonto",SEK,2023-06-02,2023-06-02,2023-06-05,"6428437","Bankgiro inbetalning",23000.00,70803.37
282,83139,0741326839,"Företagskonto",SEK,2023-05-31,2023-05-31,2023-05-30,"83139741326862","Överföring via internet",-6000.00,47803.37
283,83139,0741326839,"Företagskonto",SEK,2023-05-30,2023-05-30,2023-06-01,"6428437","Bankgiro inbetalning",1276.00,53803.37
284,83139,0741326839,"Företagskonto",SEK,2023-05-23,2023-05-23,2023-05-23,"83139741326862","Överföring via internet",-14800.00,52527.37
285,83139,0741326839,"Företagskonto",SEK,2023-05-19,2023-05-18,2023-05-18,"Intervjumat","Överföring via internet",-255.00,67327.37
286,83139,0741326839,"Företagskonto",SEK,2023-05-17,2023-05-17,2023-05-19,"6428437","Bankgiro inbetalning",26765.00,67582.37
287,83139,0741326839,"Företagskonto",SEK,2023-05-17,2023-05-17,2023-05-17,"Saft Deltagareav","Bg-bet. via internet",-3750.00,40817.37
288,83139,0741326839,"Företagskonto",SEK,2023-05-17,2023-05-17,2023-05-17,"Laga NyckDep","Överföring via internet",-300.00,44567.37
289,83139,0741326839,"Företagskonto",SEK,2023-05-17,2023-05-17,2023-05-17,"Städartiklar","Överföring via internet",-171.80,44867.37
290,83139,0741326839,"Företagskonto",SEK,2023-05-17,2023-05-17,2023-05-17,"Revisormat","Överföring via internet",-85.00,45039.17
291,83139,0741326839,"Företagskonto",SEK,2023-05-17,2023-05-17,2023-05-17,"Blommor IKEA","Överföring via internet",-300.00,45124.17
292,83139,0741326839,"Företagskonto",SEK,2023-05-17,2023-05-17,2023-05-17,"Laga NyckDep","Överföring via internet",-300.00,45424.17
293,83139,0741326839,"Företagskonto",SEK,2023-05-17,2023-05-17,2023-05-17,"Laga NyckDep","Överföring via internet",-500.00,45724.17
294,83139,0741326839,"Företagskonto",SEK,2023-05-17,2023-05-17,2023-05-17,"Diesel","Överföring via internet",-1192.11,46224.17
295,83139,0741326839,"Företagskonto",SEK,2023-05-17,2023-05-17,2023-05-17,"CeqPris","Överföring via internet",-1200.00,47416.28
296,83139,0741326839,"Företagskonto",SEK,2023-05-17,2023-05-17,2023-05-17,"Intervjumat","Överföring via internet",-170.00,48616.28
297,83139,0741326839,"Företagskonto",SEK,2023-05-17,2023-05-17,2023-05-17,"NyckelDep","Överföring via internet",-500.00,48786.28
298,83139,0741326839,"Företagskonto",SEK,2023-05-17,2023-05-17,2023-05-17,"Nyckel Depositio","Överföring via internet",-300.00,49286.28
299,83139,0741326839,"Företagskonto",SEK,2023-05-17,2023-05-17,2023-05-17,"Laga NyckDep","Överföring via internet",-300.00,49586.28
300,83139,0741326839,"Företagskonto",SEK,2023-05-17,2023-05-17,2023-05-17,"Kontorsmaterial","Överföring via internet",-20.00,49886.28
301,83139,0741326839,"Företagskonto",SEK,2023-05-17,2023-05-17,2023-05-17,"NyckelDep","Överföring via internet",-300.00,49906.28
302,83139,0741326839,"Företagskonto",SEK,2023-05-17,2023-05-17,2023-05-17,"Syjunta","Överföring via internet",-203.00,50206.28
303,83139,0741326839,"Företagskonto",SEK,2023-05-17,2023-05-17,2023-05-17,"Laga NyckDep","Överföring via internet",-300.00,50409.28
304,83139,0741326839,"Företagskonto",SEK,2023-05-17,2023-05-17,2023-05-17,"Laga NyckDep","Överföring via internet",-300.00,50709.28
305,83139,0741326839,"Företagskonto",SEK,2023-05-17,2023-05-17,2023-05-17,"NyckelDep","Överföring via internet",-300.00,51009.28
306,83139,0741326839,"Företagskonto",SEK,2023-05-17,2023-05-17,2023-05-17,"Kontorsmaterial","Överföring via internet",-298.00,51309.28
307,83139,0741326839,"Företagskonto",SEK,2023-05-17,2023-05-17,2023-05-17,"NyckelDep","Överföring via internet",-300.00,51607.28
308,83139,0741326839,"Företagskonto",SEK,2023-05-17,2023-05-17,2023-05-17,"Bågfil","Överföring via internet",-129.00,51907.28
309,83139,0741326839,"Företagskonto",SEK,2023-05-17,2023-05-17,2023-05-17,"NyckelDep","Överföring via internet",-500.00,52036.28
310,83139,0741326839,"Företagskonto",SEK,2023-05-17,2023-05-17,2023-05-17,"Laga NyckDep","Överföring via internet",-300.00,52536.28
311,83139,0741326839,"Företagskonto",SEK,2023-05-17,2023-05-17,2023-05-17,"NyckelDep","Överföring via internet",-300.00,52836.28
312,83139,0741326839,"Företagskonto",SEK,2023-05-17,2023-05-17,2023-05-17,"Laga NyckDep","Överföring via internet",-300.00,53136.28
313,83139,0741326839,"Företagskonto",SEK,2023-05-17,2023-05-17,2023-05-17,"NyckelDep","Överföring via internet",-300.00,53436.28
314,83139,0741326839,"Företagskonto",SEK,2023-05-17,2023-05-17,2023-05-17,"Revisormat","Överföring via internet",-85.00,53736.28
315,83139,0741326839,"Företagskonto",SEK,2023-05-17,2023-05-17,2023-05-17,"Syjunta","Överföring via internet",-161.00,53821.28
316,83139,0741326839,"Företagskonto",SEK,2023-05-17,2023-05-17,2023-05-17,"Laga NyckDep","Överföring via internet",-300.00,53982.28
317,83139,0741326839,"Företagskonto",SEK,2023-05-17,2023-05-17,2023-05-17,"NyckelDep","Överföring via internet",-300.00,54282.28
318,83139,0741326839,"Företagskonto",SEK,2023-05-17,2023-05-17,2023-05-17,"Städ artiklar","Överföring via internet",-123.80,54582.28
319,83139,0741326839,"Företagskonto",SEK,2023-05-17,2023-05-17,2023-05-17,"Bokföringsmat","Överföring via internet",-85.00,54706.08
320,83139,0741326839,"Företagskonto",SEK,2023-05-17,2023-05-17,2023-05-17,"Syjunta","Överföring via internet",-55.00,54791.08
321,83139,0741326839,"Företagskonto",SEK,2023-05-16,2023-05-16,2023-05-17,"6428437","Bankgiro inbetalning",1400.00,54846.08
322,83139,0741326839,"Företagskonto",SEK,2023-05-16,2023-05-16,2023-05-16,"Hoodies Studierå","Bg-bet. via internet",-2476.00,53446.08
323,83139,0741326839,"Företagskonto",SEK,2023-05-16,2023-05-16,2023-05-16,"Internöverföring","Överföring via internet",-5863.59,55922.08
324,83139,0741326839,"Företagskonto",SEK,2023-05-16,2023-05-15,2023-05-15,"83139741326862","Överföring via internet",23000.00,61785.67
325,83139,0741326839,"Företagskonto",SEK,2023-05-15,2023-05-15,2023-05-15,"Backvagnar (igen","Bg-bet. via internet",-10350.00,38785.67
326,83139,0741326839,"Företagskonto",SEK,2023-05-15,2023-05-15,2023-05-15,"Bokslut + annat","Bg-bet. via internet",-18225.00,49135.67
327,83139,0741326839,"Företagskonto",SEK,2023-05-15,2023-05-15,2023-05-15,"Tryckerikostnade","Bg-bet. via internet",-135.13,67360.67
328,83139,0741326839,"Företagskonto",SEK,2023-05-15,2023-05-15,2023-05-15,"Hallon Tandem","Bg-bet. via internet",-210.00,67495.80
329,83139,0741326839,"Företagskonto",SEK,2023-05-10,2023-05-09,2023-05-09,"83139741326862","Överföring via internet",-4000.00,67705.80
330,83139,0741326839,"Företagskonto",SEK,2023-05-10,2023-05-10,2023-05-10,"83139741326862","Överföring via internet",-6000.00,71705.80
331,83139,0741326839,"Företagskonto",SEK,2023-05-09,2023-05-09,2023-05-10,"6428437","Bankgiro inbetalning",25000.00,77705.80
332,83139,0741326839,"Företagskonto",SEK,2023-05-09,2023-05-09,2023-05-09,"83139741326862","Överföring via internet",-2000.00,52705.80
333,83139,0741326839,"Företagskonto",SEK,2023-05-09,2023-05-09,2023-05-09,"83139741326862","Överföring via internet",-40000.00,54705.80
334,83139,0741326839,"Företagskonto",SEK,2023-05-08,2023-05-07,2023-05-07,"83139741326862","Överföring via internet",-17000.00,94705.80
335,83139,0741326839,"Företagskonto",SEK,2023-05-03,2023-05-03,2023-05-03,"83139741326862","Överföring via internet",-19000.00,111705.80
336,83139,0741326839,"Företagskonto",SEK,2023-05-02,2023-05-02,2023-05-02,"83139741326862","Överföring via internet",-2000.00,130705.80
337,83139,0741326839,"Företagskonto",SEK,2023-05-02,2023-04-29,2023-04-29,"Kontorsmaterial","Bg-bet. via internet",-3816.00,132705.80
338,83139,0741326839,"Företagskonto",SEK,2023-05-02,2023-04-29,2023-04-29,"Lokalhyra Skifte","Bg-bet. via internet",-14631.00,136521.80
339,83139,0741326839,"Företagskonto",SEK,2023-05-02,2023-04-29,2023-04-29,"Livsmedelskontro","Bg-bet. via internet",-2674.00,151152.80
340,83139,0741326839,"Företagskonto",SEK,2023-05-02,2023-04-29,2023-04-29,"Arbetskläder FNU","Bg-bet. via internet",-4897.00,153826.80
341,83139,0741326839,"Företagskonto",SEK,2023-05-02,2023-04-29,2023-04-29,"Batterier 2","Bg-bet. via internet",-1607.00,158723.80
342,83139,0741326839,"Företagskonto",SEK,2023-05-02,2023-04-29,2023-04-29,"Batterier 1","Bg-bet. via internet",-1348.00,160330.80
343,83139,0741326839,"Företagskonto",SEK,2023-05-02,2023-04-29,2023-04-29,"Present ING","Överföring via internet",-75.90,161678.80
344,83139,0741326839,"Företagskonto",SEK,2023-05-02,2023-04-29,2023-04-29,"Wii Inköp","Överföring via internet",-843.00,161754.70
345,83139,0741326839,"Företagskonto",SEK,2023-05-02,2023-04-29,2023-04-29,"ledningsSkål","Överföring via internet",-342.00,162597.70
346,83139,0741326839,"Företagskonto",SEK,2023-05-02,2023-04-29,2023-04-29,"Sprayfärg","Överföring via internet",-149.80,162939.70
347,83139,0741326839,"Företagskonto",SEK,2023-05-02,2023-04-29,2023-04-29,"Klättring","Överföring via internet",-800.00,163089.50
348,83139,0741326839,"Företagskonto",SEK,2023-05-02,2023-04-29,2023-04-29,"Värd Tack","Överföring via internet",-531.00,163889.50
349,83139,0741326839,"Företagskonto",SEK,2023-05-02,2023-04-29,2023-04-29,"Värd Tack","Överföring via internet",-592.00,164420.50
350,83139,0741326839,"Företagskonto",SEK,2023-05-02,2023-04-29,2023-04-29,"Tandemutrustning","Överföring via internet",-1470.80,165012.50
351,83139,0741326839,"Företagskonto",SEK,2023-05-02,2023-04-29,2023-04-29,"VonTänen Testar","Överföring via internet",-100.00,166483.30
352,83139,0741326839,"Företagskonto",SEK,2023-05-02,2023-04-29,2023-04-29,"Tv fot","Överföring via internet",-187.09,166583.30
353,83139,0741326839,"Företagskonto",SEK,2023-05-02,2023-04-29,2023-04-29,"Värd tack","Överföring via internet",-657.55,166770.39
354,83139,0741326839,"Företagskonto",SEK,2023-05-02,2023-04-29,2023-04-29,"CykelPump","Överföring via internet",-129.00,167427.94
355,83139,0741326839,"Företagskonto",SEK,2023-05-02,2023-04-29,2023-04-29,"CEQ-pris","Överföring via internet",-1200.00,167556.94
356,83139,0741326839,"Företagskonto",SEK,2023-05-02,2023-04-29,2023-04-29,"VonTänen","Överföring via internet",-20.90,168756.94
357,83139,0741326839,"Företagskonto",SEK,2023-05-02,2023-04-29,2023-04-29,"MötesMat","Överföring via internet",-510.00,168777.84
358,83139,0741326839,"Företagskonto",SEK,2023-05-02,2023-04-29,2023-04-29,"Wii","Överföring via internet",-600.00,169287.84
359,83139,0741326839,"Företagskonto",SEK,2023-04-28,2023-04-28,2023-04-28,"1022304280018262","Pris avisering",-10.00,169887.84
360,83139,0741326839,"Företagskonto",SEK,2023-04-28,2023-04-28,2023-05-02,"1022304280018262","Internationell bet",18000.00,169897.84
361,83139,0741326839,"Företagskonto",SEK,2023-04-28,2023-04-28,2023-04-28,"Internöverföring","Överföring via internet",-4400.00,151897.84
362,83139,0741326839,"Företagskonto",SEK,2023-04-26,2023-04-26,2023-04-27,"6428437","Bankgiro inbetalning",50.00,156297.84
363,83139,0741326839,"Företagskonto",SEK,2023-04-25,2023-04-25,2023-04-25,"83139741326862","Överföring via internet",-4000.00,156247.84
364,83139,0741326839,"Företagskonto",SEK,2023-04-24,2023-04-24,2023-04-24,"83139741326862","Överföring via internet",-5000.00,160247.84
365,83139,0741326839,"Företagskonto",SEK,2023-04-21,2023-04-21,2023-04-21,"Återbetalning Fa","Överföring via internet",-250.00,165247.84
366,83139,0741326839,"Företagskonto",SEK,2023-04-20,2023-04-20,2023-04-21,"6428437","Bankgiro inbetalning",134075.00,165497.84
367,83139,0741326839,"Företagskonto",SEK,2023-04-18,2023-04-18,2023-04-19,"6428437","Bankgiro inbetalning",150.00,31422.84
368,83139,0741326839,"Företagskonto",SEK,2023-04-12,2023-04-12,2023-04-12,"83139741326862","Överföring via internet",-1400.00,31272.84
369,83139,0741326839,"Företagskonto",SEK,2023-04-11,2023-04-11,2023-04-12,"6428437","Bankgiro inbetalning",20000.00,32672.84
370,83139,0741326839,"Företagskonto",SEK,2023-04-11,2023-04-11,2023-04-11,"Förköp ÖG Fadder","Bg-bet. via internet",-7800.00,12672.84
371,83139,0741326839,"Företagskonto",SEK,2023-04-11,2023-04-11,2023-04-11,"Tryckerikostnade","Bg-bet. via internet",-1882.00,20472.84
372,83139,0741326839,"Företagskonto",SEK,2023-04-11,2023-04-11,2023-04-11,"Hoppborg Skvalbo","Bg-bet. via internet",-2500.00,22354.84
373,83139,0741326839,"Företagskonto",SEK,2023-04-03,2023-04-03,2023-04-04,"6428437","Bankgiro inbetalning",100.00,24854.84
374,83139,0741326839,"Företagskonto",SEK,2023-04-03,2023-04-03,2023-04-03,"83139741326862","Överföring via internet",-1.00,24754.84
375,83139,0741326839,"Företagskonto",SEK,2023-03-30,2023-03-30,2023-03-30,"Betalning Saft 2","Bg-bet. via internet",-398.00,24755.84
376,83139,0741326839,"Företagskonto",SEK,2023-03-30,2023-03-30,2023-03-30,"Buss Ölreise","Bg-bet. via internet",-10995.00,25153.84
377,83139,0741326839,"Företagskonto",SEK,2023-03-30,2023-03-30,2023-03-30,"Mat till Proposi","Överföring via internet",-85.00,36148.84
378,83139,0741326839,"Företagskonto",SEK,2023-03-30,2023-03-30,2023-03-30,"Mat till Proposi","Överföring via internet",-425.00,36233.84
379,83139,0741326839,"Företagskonto",SEK,2023-03-30,2023-03-30,2023-03-30,"Medaljutdelning","Överföring via internet",-396.00,36658.84
380,83139,0741326839,"Företagskonto",SEK,2023-03-30,2023-03-30,2023-03-30,"Revisormat","Överföring via internet",-61.00,37054.84
381,83139,0741326839,"Företagskonto",SEK,2023-03-30,2023-03-30,2023-03-30,"Värdtack FARAD","Överföring via internet",-518.10,37115.84
382,83139,0741326839,"Företagskonto",SEK,2023-03-30,2023-03-30,2023-03-30,"Vontänen Släpp","Överföring via internet",-79.00,37633.94
383,83139,0741326839,"Företagskonto",SEK,2023-03-30,2023-03-30,2023-03-30,"Fika Likabehandl","Överföring via internet",-311.40,37712.94
384,83139,0741326839,"Företagskonto",SEK,2023-03-30,2023-03-30,2023-03-30,"Bokföringsmat","Överföring via internet",-85.00,38024.34
385,83139,0741326839,"Företagskonto",SEK,2023-03-30,2023-03-30,2023-03-30,"Revisormat","Överföring via internet",-84.70,38109.34
386,83139,0741326839,"Företagskonto",SEK,2023-03-30,2023-03-30,2023-03-30,"Syjunta Material","Överföring via internet",-298.00,38194.04
387,83139,0741326839,"Företagskonto",SEK,2023-03-30,2023-03-30,2023-03-30,"Mat till protoko","Överföring via internet",-571.00,38492.04
388,83139,0741326839,"Företagskonto",SEK,2023-03-30,2023-03-30,2023-03-30,"Fika Likabehandl","Överföring via internet",-494.80,39063.04
389,83139,0741326839,"Företagskonto",SEK,2023-03-30,2023-03-30,2023-03-30,"Mat till Proposi","Överföring via internet",-85.00,39557.84
390,83139,0741326839,"Företagskonto",SEK,2023-03-30,2023-03-30,2023-03-30,"Revisormat","Överföring via internet",-170.00,39642.84
391,83139,0741326839,"Företagskonto",SEK,2023-03-29,2023-03-29,2023-03-30,"6428437","Bankgiro inbetalning",195.00,39812.84
392,83139,0741326839,"Företagskonto",SEK,2023-03-29,2023-03-29,2023-03-29,"Internöverföring","Överföring via internet",-17000.00,39617.84
393,83139,0741326839,"Företagskonto",SEK,2023-03-28,2023-03-28,2023-03-28,"83139741326862","Överföring via internet",-7500.00,56617.84
394,83139,0741326839,"Företagskonto",SEK,2023-03-27,2023-03-27,2023-03-28,"6428437","Bankgiro inbetalning",510.00,64117.84
395,83139,0741326839,"Företagskonto",SEK,2023-03-27,2023-03-25,2023-03-25,"83139741326870","Överföring via internet",-15000.00,63607.84
396,83139,0741326839,"Företagskonto",SEK,2023-03-24,2023-03-24,2023-03-24,"Betalning Fotbol","Pg-bet. via internet",-1500.00,78607.84
397,83139,0741326839,"Företagskonto",SEK,2023-03-22,2023-03-22,2023-03-22,"Intervjumat","Överföring via internet",-170.00,80107.84
398,83139,0741326839,"Företagskonto",SEK,2023-03-22,2023-03-22,2023-03-22,"Intervjumat","Överföring via internet",-170.00,80277.84
399,83139,0741326839,"Företagskonto",SEK,2023-03-22,2023-03-22,2023-03-22,"Intervjumat","Överföring via internet",-85.00,80447.84
400,83139,0741326839,"Företagskonto",SEK,2023-03-22,2023-03-22,2023-03-22,"Intervjumat","Överföring via internet",-170.00,80532.84
401,83139,0741326839,"Företagskonto",SEK,2023-03-22,2023-03-22,2023-03-22,"Intervjumat","Överföring via internet",-170.00,80702.84
402,83139,0741326839,"Företagskonto",SEK,2023-03-22,2023-03-22,2023-03-22,"Intervjumat","Överföring via internet",-85.00,80872.84
403,83139,0741326839,"Företagskonto",SEK,2023-03-22,2023-03-22,2023-03-22,"Intervjumat","Överföring via internet",-255.00,80957.84
404,83139,0741326839,"Företagskonto",SEK,2023-03-22,2023-03-22,2023-03-22,"Intervjumat","Överföring via internet",-85.00,81212.84
405,83139,0741326839,"Företagskonto",SEK,2023-03-22,2023-03-22,2023-03-22,"Intervjumat","Överföring via internet",-85.00,81297.84
406,83139,0741326839,"Företagskonto",SEK,2023-03-21,2023-03-21,2023-03-21,"Fordonsskatt","Bg-bet. via internet",-1733.00,81382.84
407,83139,0741326839,"Företagskonto",SEK,2023-03-21,2023-03-21,2023-03-21,"Farad Bord o Sto","Bg-bet. via internet",-13238.00,83115.84
408,83139,0741326839,"Företagskonto",SEK,2023-03-21,2023-03-21,2023-03-21,"CykelSaker","Överföring via internet",-958.20,96353.84
409,83139,0741326839,"Företagskonto",SEK,2023-03-21,2023-03-21,2023-03-21,"Revisormat","Överföring via internet",-170.00,97312.04
410,83139,0741326839,"Företagskonto",SEK,2023-03-21,2023-03-21,2023-03-21,"Bokföringsmat","Överföring via internet",-80.00,97482.04
411,83139,0741326839,"Företagskonto",SEK,2023-03-21,2023-03-21,2023-03-21,"Parkering","Överföring via internet",-143.00,97562.04
412,83139,0741326839,"Företagskonto",SEK,2023-03-21,2023-03-21,2023-03-21,"Bokföringsmat","Överföring via internet",-85.00,97705.04
413,83139,0741326839,"Företagskonto",SEK,2023-03-20,2023-03-20,2023-03-20,"Internöverföring","Överföring via internet",12689.00,97790.04
414,83139,0741326839,"Företagskonto",SEK,2023-03-20,2023-03-20,2023-03-20,"Internövföring","Överföring via internet",-7000.00,85101.04
415,83139,0741326839,"Företagskonto",SEK,2023-03-15,2023-03-15,2023-03-16,"6428437","Bankgiro inbetalning",270.00,92101.04
416,83139,0741326839,"Företagskonto",SEK,2023-03-13,2023-03-13,2023-03-14,"6428437","Bankgiro inbetalning",175.00,91831.04
417,83139,0741326839,"Företagskonto",SEK,2023-03-13,2023-03-13,2023-03-13,"1022303130010591","Pris avisering",-10.00,91656.04
418,83139,0741326839,"Företagskonto",SEK,2023-03-13,2023-03-13,2023-03-14,"1022303130010591","Internationell bet",4000.00,91666.04
419,83139,0741326839,"Företagskonto",SEK,2023-03-10,2023-03-10,2023-03-13,"6428437","Bankgiro inbetalning",4590.00,87666.04
420,83139,0741326839,"Företagskonto",SEK,2023-03-08,2023-03-08,2023-03-09,"6428437","Bankgiro inbetalning",57.06,83076.04
421,83139,0741326839,"Företagskonto",SEK,2023-03-08,2023-03-08,2023-03-08,"EHusetTryckeri","Bg-bet. via internet",-403.00,83018.98
422,83139,0741326839,"Företagskonto",SEK,2023-03-08,2023-03-08,2023-03-08,"Farad Parkering","Bg-bet. via internet",-120.00,83421.98
423,83139,0741326839,"Företagskonto",SEK,2023-03-08,2023-03-08,2023-03-08,"Farad Mattor","Bg-bet. via internet",-2100.00,83541.98
424,83139,0741326839,"Företagskonto",SEK,2023-03-08,2023-03-08,2023-03-08,"Mikrofoner","Bg-bet. via internet",-5000.00,85641.98
425,83139,0741326839,"Företagskonto",SEK,2023-03-08,2023-03-08,2023-03-08,"Revisorsmat","Överföring via internet",-84.70,90641.98
426,83139,0741326839,"Företagskonto",SEK,2023-03-08,2023-03-08,2023-03-08,"godis smurf","Överföring via internet",-279.33,90726.68
427,83139,0741326839,"Företagskonto",SEK,2023-03-08,2023-03-08,2023-03-08,"Revisorsmat","Överföring via internet",-64.00,91006.01
428,83139,0741326839,"Företagskonto",SEK,2023-03-08,2023-03-08,2023-03-08,"Bokföringsmat","Överföring via internet",-85.00,91070.01
429,83139,0741326839,"Företagskonto",SEK,2023-03-08,2023-03-08,2023-03-08,"Transformator","Överföring via internet",-2627.00,91155.01
430,83139,0741326839,"Företagskonto",SEK,2023-03-08,2023-03-08,2023-03-08,"Tandem","Överföring via internet",-3500.00,93782.01
431,83139,0741326839,"Företagskonto",SEK,2023-03-08,2023-03-08,2023-03-08,"K sek Present","Överföring via internet",-399.00,97282.01
432,83139,0741326839,"Företagskonto",SEK,2023-03-08,2023-03-08,2023-03-08,"@1337 Fika","Överföring via internet",-104.70,97681.01
433,83139,0741326839,"Företagskonto",SEK,2023-03-08,2023-03-08,2023-03-08,"Milersättning","Överföring via internet",-185.00,97785.71
434,83139,0741326839,"Företagskonto",SEK,2023-03-08,2023-03-08,2023-03-08,"code sprint mat","Överföring via internet",-834.00,97970.71
435,83139,0741326839,"Företagskonto",SEK,2023-03-08,2023-03-08,2023-03-08,"Klubbor","Överföring via internet",-150.00,98804.71
436,83139,0741326839,"Företagskonto",SEK,2023-03-08,2023-03-08,2023-03-08,"Revisorsmat","Överföring via internet",-170.00,98954.71
437,83139,0741326839,"Företagskonto",SEK,2023-03-08,2023-03-08,2023-03-08,"Ljus","Överföring via internet",-114.75,99124.71
438,83139,0741326839,"Företagskonto",SEK,2023-03-08,2023-03-08,2023-03-08,"Farad Märken","Överföring via internet",-1246.00,99239.46
439,83139,0741326839,"Företagskonto",SEK,2023-03-08,2023-03-08,2023-03-08,"Revisorsmat","Överföring via internet",-85.00,100485.46
440,83139,0741326839,"Företagskonto",SEK,2023-03-07,2023-03-07,2023-03-08,"6428437","Bankgiro inbetalning",556.32,100570.46
441,83139,0741326839,"Företagskonto",SEK,2023-03-06,2023-03-06,2023-03-07,"6428437","Bankgiro inbetalning",20000.00,100014.14
442,83139,0741326839,"Företagskonto",SEK,2023-03-03,2023-03-03,2023-03-06,"6428437","Bankgiro inbetalning",133.00,80014.14
443,83139,0741326839,"Företagskonto",SEK,2023-03-03,2023-03-03,2023-03-03,"Betalning Domän","Bg-bet. via internet",-236.25,79881.14
444,83139,0741326839,"Företagskonto",SEK,2023-03-02,2023-03-02,2023-03-03,"6428437","Bankgiro inbetalning",2000.00,80117.39
445,83139,0741326839,"Företagskonto",SEK,2023-03-01,2023-03-01,2023-03-02,"6428437","Bankgiro inbetalning",450.00,78117.39
446,83139,0741326839,"Företagskonto",SEK,2023-03-01,2023-03-01,2023-03-01,"Intervjumat","Överföring via internet",-80.00,77667.39
447,83139,0741326839,"Företagskonto",SEK,2023-03-01,2023-03-01,2023-03-01,"Intervjumat","Överföring via internet",-80.00,77747.39
448,83139,0741326839,"Företagskonto",SEK,2023-03-01,2023-03-01,2023-03-01,"Intervjumat","Överföring via internet",-57.53,77827.39
449,83139,0741326839,"Företagskonto",SEK,2023-03-01,2023-03-01,2023-03-01,"Intervjumat","Överföring via internet",-68.80,77884.92
450,83139,0741326839,"Företagskonto",SEK,2023-02-28,2023-02-28,2023-03-01,"6428437","Bankgiro inbetalning",225.00,77953.72
451,83139,0741326839,"Företagskonto",SEK,2023-02-28,2023-02-28,2023-02-28,"Intervjumat","Överföring via internet",-72.00,77728.72
452,83139,0741326839,"Företagskonto",SEK,2023-02-28,2023-02-28,2023-02-28,"Intervjumat","Överföring via internet",-80.00,77800.72
453,83139,0741326839,"Företagskonto",SEK,2023-02-28,2023-02-28,2023-02-28,"Intervjumat","Överföring via internet",-82.00,77880.72
454,83139,0741326839,"Företagskonto",SEK,2023-02-28,2023-02-28,2023-02-28,"Intervjumat","Överföring via internet",-73.00,77962.72
455,83139,0741326839,"Företagskonto",SEK,2023-02-28,2023-02-28,2023-02-28,"Intervjumat","Överföring via internet",-80.00,78035.72
456,83139,0741326839,"Företagskonto",SEK,2023-02-28,2023-02-28,2023-02-28,"Intervjumat","Överföring via internet",-85.00,78115.72
457,83139,0741326839,"Företagskonto",SEK,2023-02-28,2023-02-28,2023-02-28,"Intervjumat","Överföring via internet",-85.00,78200.72
458,83139,0741326839,"Företagskonto",SEK,2023-02-28,2023-02-28,2023-02-28,"Intervjumat","Överföring via internet",-170.00,78285.72
459,83139,0741326839,"Företagskonto",SEK,2023-02-28,2023-02-28,2023-02-28,"Intervjumat","Överföring via internet",-85.00,78455.72
460,83139,0741326839,"Företagskonto",SEK,2023-02-28,2023-02-28,2023-02-28,"Intervjumat","Överföring via internet",-255.00,78540.72
461,83139,0741326839,"Företagskonto",SEK,2023-02-28,2023-02-28,2023-02-28,"Intervjumat","Överföring via internet",-85.00,78795.72
462,83139,0741326839,"Företagskonto",SEK,2023-02-28,2023-02-28,2023-02-28,"Intervjumat","Överföring via internet",-68.00,78880.72
463,83139,0741326839,"Företagskonto",SEK,2023-02-28,2023-02-28,2023-02-28,"Intervjumat","Överföring via internet",-76.00,78948.72
464,83139,0741326839,"Företagskonto",SEK,2023-02-28,2023-02-28,2023-02-28,"Intervjumat","Överföring via internet",-82.00,79024.72
465,83139,0741326839,"Företagskonto",SEK,2023-02-27,2023-02-27,2023-02-28,"6428437","Bankgiro inbetalning",590.00,79106.72
466,83139,0741326839,"Företagskonto",SEK,2023-02-27,2023-02-27,2023-02-27,"Sexet Brodyr","Bg-bet. via internet",-7237.50,78516.72
467,83139,0741326839,"Företagskonto",SEK,2023-02-27,2023-02-27,2023-02-27,"FNU Kick Off","Överföring via internet",-380.56,85754.22
468,83139,0741326839,"Företagskonto",SEK,2023-02-27,2023-02-27,2023-02-27,"Carrom bräde","Överföring via internet",-1244.80,86134.78
469,83139,0741326839,"Företagskonto",SEK,2023-02-27,2023-02-27,2023-02-27,"CEQ-mat","Överföring via internet",-61.00,87379.58
470,83139,0741326839,"Företagskonto",SEK,2023-02-27,2023-02-27,2023-02-27,"Svetshjälm","Överföring via internet",-250.00,87440.58
471,83139,0741326839,"Företagskonto",SEK,2023-02-27,2023-02-27,2023-02-27,"Svetsförkläde","Överföring via internet",-499.00,87690.58
472,83139,0741326839,"Företagskonto",SEK,2023-02-27,2023-02-27,2023-02-27,"Svetshandskar","Överföring via internet",-119.00,88189.58
473,83139,0741326839,"Företagskonto",SEK,2023-02-27,2023-02-27,2023-02-27,"Pingisbordsfrakt","Överföring via internet",-66.60,88308.58
474,83139,0741326839,"Företagskonto",SEK,2023-02-24,2023-02-24,2023-02-24,"83139741326862","Överföring via internet",-17000.00,88375.18
475,83139,0741326839,"Företagskonto",SEK,2023-02-24,2023-02-24,2023-02-24,"83139741326862","Överföring via internet",-15000.00,105375.18
476,83139,0741326839,"Företagskonto",SEK,2023-02-24,2023-02-24,2023-02-24,"Internöverföring","Överföring via internet",100000.00,120375.18
477,83139,0741326839,"Företagskonto",SEK,2023-02-23,2023-02-23,2023-02-23,"Internöverföring","Överföring via internet",-10240.00,20375.18
478,83139,0741326839,"Företagskonto",SEK,2023-02-22,2023-02-22,2023-02-22,"Intervjumat","Överföring via internet",-150.00,30615.18
479,83139,0741326839,"Företagskonto",SEK,2023-02-22,2023-02-22,2023-02-22,"Arbetskläder FAR","Överföring via internet",-3200.00,30765.18
480,83139,0741326839,"Företagskonto",SEK,2023-02-21,2023-02-21,2023-02-21,"Internöverföring","Överföring via internet",30000.00,33965.18
481,83139,0741326839,"Företagskonto",SEK,2023-02-20,2023-02-20,2023-02-20,"83139741326862","Överföring via internet",-2200.00,3965.18
482,83139,0741326839,"Företagskonto",SEK,2023-02-20,2023-02-18,2023-02-18,"83139741326862","Överföring via internet",-1000.00,6165.18
483,83139,0741326839,"Företagskonto",SEK,2023-02-20,2023-02-18,2023-02-18,"83139741326862","Överföring via internet",-2000.00,7165.18
484,83139,0741326839,"Företagskonto",SEK,2023-02-17,2023-02-17,2023-02-17,"Funktionärstack","Bg-bet. via internet",-36750.00,9165.18
485,83139,0741326839,"Företagskonto",SEK,2023-02-17,2023-02-17,2023-02-17,"Utskottstack","Bg-bet. via internet",-26000.00,45915.18
486,83139,0741326839,"Företagskonto",SEK,2023-02-17,2023-02-17,2023-02-17,"Pingisbollar","Pg-bet. via internet",-389.00,71915.18
487,83139,0741326839,"Företagskonto",SEK,2023-02-17,2023-02-17,2023-02-17,"AnmälanFotboll","Pg-bet. via internet",-1600.00,72304.18
488,83139,0741326839,"Företagskonto",SEK,2023-02-17,2023-02-17,2023-02-17,"AnmälanVolleybol","Pg-bet. via internet",-1300.00,73904.18
489,83139,0741326839,"Företagskonto",SEK,2023-02-17,2023-02-17,2023-02-17,"Donation Regnbåg","Överföring via internet",-1735.50,75204.18
490,83139,0741326839,"Företagskonto",SEK,2023-02-17,2023-02-17,2023-02-17,"Revisormat","Överföring via internet",-170.00,76939.68
491,83139,0741326839,"Företagskonto",SEK,2023-02-17,2023-02-17,2023-02-17,"83139742551138","Överföring via internet",30000.00,77109.68
492,83139,0741326839,"Företagskonto",SEK,2023-02-17,2023-02-17,2023-02-17,"Milersättning","Överföring via internet",-185.00,47109.68
493,83139,0741326839,"Företagskonto",SEK,2023-02-17,2023-02-17,2023-02-17,"PingisPriser","Överföring via internet",-84.00,47294.68
494,83139,0741326839,"Företagskonto",SEK,2023-02-17,2023-02-17,2023-02-17,"Bokföringsmat","Överföring via internet",-85.00,47378.68
495,83139,0741326839,"Företagskonto",SEK,2023-02-17,2023-02-17,2023-02-17,"FARAD","Överföring via internet",-2705.81,47463.68
496,83139,0741326839,"Företagskonto",SEK,2023-02-17,2023-02-17,2023-02-17,"83139742551138","Överföring via internet",20000.00,50169.49
497,83139,0741326839,"Företagskonto",SEK,2023-02-17,2023-02-17,2023-02-17,"Milersättning","Överföring via internet",-203.50,30169.49
498,83139,0741326839,"Företagskonto",SEK,2023-02-17,2023-02-17,2023-02-17,"Internöverföring","Överföring via internet",30000.00,30372.99
499,83139,0741326839,"Företagskonto",SEK,2023-02-17,2023-02-17,2023-02-17,"Alkohol KMtack","Överföring via internet",-3933.40,372.99
500,83139,0741326839,"Företagskonto",SEK,2023-02-17,2023-02-17,2023-02-17,"Bokföringsmat","Överföring via internet",-85.00,4306.39
501,83139,0741326839,"Företagskonto",SEK,2023-02-16,2023-02-16,2023-02-17,"6428437","Bankgiro inbetalning",390.00,4391.39
502,83139,0741326839,"Företagskonto",SEK,2023-02-14,2023-02-14,2023-02-15,"6428437","Bankgiro inbetalning",4500.00,4001.39
503,83139,0741326839,"Företagskonto",SEK,2023-02-14,2023-02-14,2023-02-14,"Farad","Överföring via internet",-565.00,-498.61
504,83139,0741326839,"Företagskonto",SEK,2023-02-14,2023-02-14,2023-02-14,"LedningsskifteMa","Överföring via internet",-251.20,66.39
505,83139,0741326839,"Företagskonto",SEK,2023-02-14,2023-02-14,2023-02-14,"Farad","Överföring via internet",-17.90,317.59
506,83139,0741326839,"Företagskonto",SEK,2023-02-14,2023-02-14,2023-02-14,"Farad","Överföring via internet",-286.42,335.49
507,83139,0741326839,"Företagskonto",SEK,2023-02-14,2023-02-14,2023-02-14,"Farad","Överföring via internet",-1938.69,621.91
508,83139,0741326839,"Företagskonto",SEK,2023-02-14,2023-02-14,2023-02-14,"Ceq Tävlingspris","Överföring via internet",-1200.00,2560.60
509,83139,0741326839,"Företagskonto",SEK,2023-02-14,2023-02-14,2023-02-14,"Intervjumat","Överföring via internet",-85.00,3760.60
510,83139,0741326839,"Företagskonto",SEK,2023-02-14,2023-02-14,2023-02-14,"KakorHTF","Överföring via internet",-46.50,3845.60
511,83139,0741326839,"Företagskonto",SEK,2023-02-14,2023-02-14,2023-02-14,"Farad","Överföring via internet",-42.90,3892.10
512,83139,0741326839,"Företagskonto",SEK,2023-02-14,2023-02-14,2023-02-14,"LedningsskifteMa","Överföring via internet",-396.00,3935.00
513,83139,0741326839,"Företagskonto",SEK,2023-02-13,2023-02-13,2023-02-14,"6428437","Bankgiro inbetalning",800.00,4331.00
514,83139,0741326839,"Företagskonto",SEK,2023-02-13,2023-02-13,2023-02-13,"Tryckeri","Bg-bet. via internet",-1832.00,3531.00
515,83139,0741326839,"Företagskonto",SEK,2023-02-13,2023-02-13,2023-02-13,"Bussar FlyING","Bg-bet. via internet",-11560.00,5363.00
516,83139,0741326839,"Företagskonto",SEK,2023-02-13,2023-02-13,2023-02-13,"Släpp Lophtet","Bg-bet. via internet",-2400.00,16923.00
517,83139,0741326839,"Företagskonto",SEK,2023-02-13,2023-02-13,2023-02-13,"Symaskiner","Bg-bet. via internet",-5580.00,19323.00
518,83139,0741326839,"Företagskonto",SEK,2023-02-13,2023-02-13,2023-02-13,"Tillbehör Symask","Bg-bet. via internet",-599.00,24903.00
519,83139,0741326839,"Företagskonto",SEK,2023-02-13,2023-02-13,2023-02-13,"Tacksittning","Bg-bet. via internet",-10880.00,25502.00
520,83139,0741326839,"Företagskonto",SEK,2023-02-13,2023-02-13,2023-02-13,"+1 sittning Loph","Bg-bet. via internet",-2575.00,36382.00
521,83139,0741326839,"Företagskonto",SEK,2023-02-13,2023-02-13,2023-02-13,"83139742551138","Överföring via internet",20000.00,38957.00
522,83139,0741326839,"Företagskonto",SEK,2023-02-13,2023-02-13,2023-02-13,"Diverse Tacksitt","Överföring via internet",-188.15,18957.00
523,83139,0741326839,"Företagskonto",SEK,2023-02-13,2023-02-13,2023-02-13,"Alkohol tacksitt","Överföring via internet",-3140.40,19145.15
524,83139,0741326839,"Företagskonto",SEK,2023-02-13,2023-02-13,2023-02-13,"Internövföring","Överföring via internet",-20000.00,22285.55
525,83139,0741326839,"Företagskonto",SEK,2023-02-13,2023-02-11,2023-02-11,"83139741326862","Överföring via internet",-49.50,42285.55
526,83139,0741326839,"Företagskonto",SEK,2023-02-10,2023-02-10,2023-02-13,"6428437","Bankgiro inbetalning",595.00,42335.05
527,83139,0741326839,"Företagskonto",SEK,2023-02-09,2023-02-09,2023-02-09,"83139741326862","Överföring via internet",4200.00,41740.05
528,83139,0741326839,"Företagskonto",SEK,2023-02-08,2023-02-08,2023-02-08,"AspiaBetalning","Bg-bet. via internet",-2772.50,37540.05
529,83139,0741326839,"Företagskonto",SEK,2023-02-08,2023-02-08,2023-02-08,"GoGSalladFARAD","Bg-bet. via internet",-8062.00,40312.55
530,83139,0741326839,"Företagskonto",SEK,2023-02-08,2023-02-08,2023-02-08,"EHusetTryckeri","Bg-bet. via internet",-2537.00,48374.55
531,83139,0741326839,"Företagskonto",SEK,2023-02-08,2023-02-08,2023-02-08,"SexetKablar","Bg-bet. via internet",-250.00,50911.55
532,83139,0741326839,"Företagskonto",SEK,2023-02-08,2023-02-08,2023-02-08,"Lophtet Sexetkic","Bg-bet. via internet",-2500.00,51161.55
533,83139,0741326839,"Företagskonto",SEK,2023-02-08,2023-02-08,2023-02-08,"Intervjumat","Överföring via internet",-170.00,53661.55
534,83139,0741326839,"Företagskonto",SEK,2023-02-08,2023-02-08,2023-02-08,"AlkoholFARADPub","Överföring via internet",-2798.50,53831.55
535,83139,0741326839,"Företagskonto",SEK,2023-02-08,2023-02-08,2023-02-08,"Bänkolja","Överföring via internet",-99.90,56630.05
536,83139,0741326839,"Företagskonto",SEK,2023-02-08,2023-02-08,2023-02-08,"AllaHjärtansDag","Överföring via internet",-100.00,56729.95
537,83139,0741326839,"Företagskonto",SEK,2023-02-08,2023-02-08,2023-02-08,"AllaHjärtansDag","Överföring via internet",-60.00,56829.95
538,83139,0741326839,"Företagskonto",SEK,2023-02-08,2023-02-08,2023-02-08,"LedningsSkifte","Överföring via internet",-4769.43,56889.95
539,83139,0741326839,"Företagskonto",SEK,2023-02-08,2023-02-08,2023-02-08,"AllaHjärtansDag","Överföring via internet",-454.60,61659.38
540,83139,0741326839,"Företagskonto",SEK,2023-02-08,2023-02-08,2023-02-08,"Internöverföring","Överföring via internet",-5000.00,62113.98
541,83139,0741326839,"Företagskonto",SEK,2023-02-08,2023-02-08,2023-02-08,"AllaHjärtansDag","Överföring via internet",-195.50,67113.98
542,83139,0741326839,"Företagskonto",SEK,2023-02-08,2023-02-08,2023-02-08,"83139741326847","Överföring via internet",50000.00,67309.48
543,83139,0741326839,"Företagskonto",SEK,2023-02-07,2023-02-07,2023-02-07,"Bilreperation","Bg-bet. via internet",-6289.00,17309.48
544,83139,0741326839,"Företagskonto",SEK,2023-02-07,2023-02-07,2023-02-07,"83139741326862","Överföring via internet",-10880.00,23598.48
545,83139,0741326839,"Företagskonto",SEK,2023-02-07,2023-02-07,2023-02-07,"InternÖvf","Överföring via internet",21152.73,34478.48
546,83139,0741326839,"Företagskonto",SEK,2023-02-06,2023-02-06,2023-02-06,"83139741326862","Överföring via internet",590.00,13325.75
547,83139,0741326839,"Företagskonto",SEK,2023-02-03,2023-02-03,2023-02-03,"UtbildningFNU","Överföring via internet",-500.00,12735.75
548,83139,0741326839,"Företagskonto",SEK,2023-02-03,2023-02-03,2023-02-03,"MattejpFARAD","Överföring via internet",-1791.00,13235.75
549,83139,0741326839,"Företagskonto",SEK,2023-02-03,2023-02-03,2023-02-03,"Bokföringsmat","Överföring via internet",-85.00,15026.75
550,83139,0741326839,"Företagskonto",SEK,2023-02-03,2023-02-03,2023-02-03,"Lunchföreläsning","Överföring via internet",-119.00,15111.75
551,83139,0741326839,"Företagskonto",SEK,2023-02-02,2023-02-02,2023-02-02,"83139741326862","Överföring via internet",-14000.00,15230.75
552,83139,0741326839,"Företagskonto",SEK,2023-02-01,2023-02-01,2023-02-01,"SaftUmeåVT22","Bg-bet. via internet",-800.00,29230.75
553,83139,0741326839,"Företagskonto",SEK,2023-02-01,2023-02-01,2023-02-01,"Kostym SåS","Överföring via internet",-175.90,30030.75
554,83139,0741326839,"Företagskonto",SEK,2023-02-01,2023-02-01,2023-02-01,"FaradFika","Överföring via internet",-540.50,30206.65
555,83139,0741326839,"Företagskonto",SEK,2023-02-01,2023-02-01,2023-02-01,"Dricka och snack","Överföring via internet",-341.00,30747.15
556,83139,0741326839,"Företagskonto",SEK,2023-02-01,2023-02-01,2023-02-01,"Alkoholcaftack","Överföring via internet",-1104.00,31088.15
557,83139,0741326839,"Företagskonto",SEK,2023-02-01,2023-02-01,2023-02-01,"såsmat rep","Överföring via internet",-490.59,32192.15
558,83139,0741326839,"Företagskonto",SEK,2023-02-01,2023-02-01,2023-02-01,"FaradMat","Överföring via internet",-5101.50,32682.74
559,83139,0741326839,"Företagskonto",SEK,2023-02-01,2023-02-01,2023-02-01,"såsmat rep","Överföring via internet",-117.80,37784.24
560,83139,0741326839,"Företagskonto",SEK,2023-02-01,2023-02-01,2023-02-01,"AlkTackSex","Överföring via internet",-1877.60,37902.04
561,83139,0741326839,"Företagskonto",SEK,2023-02-01,2023-02-01,2023-02-01,"Värdutbildning","Överföring via internet",-83.30,39779.64
562,83139,0741326839,"Företagskonto",SEK,2023-02-01,2023-02-01,2023-02-01,"Kostym SåS","Överföring via internet",-791.75,39862.94
563,83139,0741326839,"Företagskonto",SEK,2023-02-01,2023-02-01,2023-02-01,"AlkoholPryltack","Överföring via internet",-1272.00,40654.69
564,83139,0741326839,"Företagskonto",SEK,2023-02-01,2023-02-01,2023-02-01,"alkfriPryTack","Överföring via internet",-250.59,41926.69
565,83139,0741326839,"Företagskonto",SEK,2023-02-01,2023-02-01,2023-02-01,"Ansvarspostutbil","Överföring via internet",-1947.00,42177.28
566,83139,0741326839,"Företagskonto",SEK,2023-02-01,2023-02-01,2023-02-01,"FaradTejp","Överföring via internet",-39.90,44124.28
567,83139,0741326839,"Företagskonto",SEK,2023-02-01,2023-02-01,2023-02-01,"SkåpLås","Överföring via internet",-1996.00,44164.18
568,83139,0741326839,"Företagskonto",SEK,2023-02-01,2023-02-01,2023-02-01,"83139741326862","Överföring via internet",-700.00,46160.18
569,83139,0741326839,"Företagskonto",SEK,2023-01-30,2023-01-30,2023-01-30,"SkiftesStuga","Bg-bet. via internet",-7000.00,46860.18
570,83139,0741326839,"Företagskonto",SEK,2023-01-30,2023-01-30,2023-01-30,"83139741326862","Överföring via internet",-1000.00,53860.18
571,83139,0741326839,"Företagskonto",SEK,2023-01-27,2023-01-27,2023-01-27,"83139741326862","Överföring via internet",-7000.00,54860.18
572,83139,0741326839,"Företagskonto",SEK,2023-01-27,2023-01-27,2023-01-27,"83139741326862","Överföring via internet",-1500.00,61860.18
573,83139,0741326839,"Företagskonto",SEK,2023-01-24,2023-01-24,2023-01-24,"Hyra Ishall","Bg-bet. via internet",-400.00,63360.18
574,83139,0741326839,"Företagskonto",SEK,2023-01-24,2023-01-24,2023-01-24,"PingisBollar","Pg-bet. via internet",-468.00,63760.18
575,83139,0741326839,"Företagskonto",SEK,2023-01-24,2023-01-24,2023-01-24,"MatSyrelseUtbild","Överföring via internet",-700.00,64228.18
576,83139,0741326839,"Företagskonto",SEK,2023-01-24,2023-01-24,2023-01-24,"Mat Bordsvise","Överföring via internet",-220.00,64928.18
577,83139,0741326839,"Företagskonto",SEK,2023-01-24,2023-01-24,2023-01-24,"AuxBil","Överföring via internet",-39.90,65148.18
578,83139,0741326839,"Företagskonto",SEK,2023-01-24,2023-01-24,2023-01-24,"Bar Bordsvise","Överföring via internet",-380.00,65188.08
579,83139,0741326839,"Företagskonto",SEK,2023-01-24,2023-01-24,2023-01-24,"TipEx Lim","Överföring via internet",-78.80,65568.08
580,83139,0741326839,"Företagskonto",SEK,2023-01-24,2023-01-24,2023-01-24,"Diesel F-bil","Överföring via internet",-1061.28,65646.88
581,83139,0741326839,"Företagskonto",SEK,2023-01-24,2023-01-24,2023-01-24,"Mat Reptillfälle","Överföring via internet",-919.32,66708.16
582,83139,0741326839,"Företagskonto",SEK,2023-01-24,2023-01-24,2023-01-24,"Scenkläder","Överföring via internet",-309.50,67627.48
583,83139,0741326839,"Företagskonto",SEK,2023-01-24,2023-01-24,2023-01-24,"CafeLås","Överföring via internet",-449.00,67936.98
584,83139,0741326839,"Företagskonto",SEK,2023-01-24,2023-01-24,2023-01-24,"Mat Bordsvise","Överföring via internet",-2156.00,68385.98
585,83139,0741326839,"Företagskonto",SEK,2023-01-24,2023-01-24,2023-01-24,"Cafe Nycklar","Överföring via internet",-280.00,70541.98
586,83139,0741326839,"Företagskonto",SEK,2023-01-24,2023-01-24,2023-01-24,"Alk Bordsvise","Överföring via internet",-627.00,70821.98
587,83139,0741326839,"Företagskonto",SEK,2023-01-24,2023-01-24,2023-01-24,"Diesel F-bil","Överföring via internet",-1198.24,71448.98
588,83139,0741326839,"Företagskonto",SEK,2023-01-24,2023-01-24,2023-01-24,"Alkohol LednTack","Överföring via internet",-2350.20,72647.22
589,83139,0741326839,"Företagskonto",SEK,2023-01-24,2023-01-24,2023-01-24,"Bokföringsmat","Överföring via internet",-170.00,74997.42
590,83139,0741326839,"Företagskonto",SEK,2023-01-24,2023-01-24,2023-01-24,"Scenkläder","Överföring via internet",-105.00,75167.42
591,83139,0741326839,"Företagskonto",SEK,2023-01-24,2023-01-24,2023-01-24,"Scenkläder","Överföring via internet",-1036.00,75272.42
592,83139,0741326839,"Företagskonto",SEK,2023-01-24,2023-01-24,2023-01-24,"Scenkläder","Överföring via internet",-185.00,76308.42
593,83139,0741326839,"Företagskonto",SEK,2023-01-23,2023-01-23,2023-01-23,"Bilförsäkring","Bg-bet. via internet",-1952.00,76493.42
594,83139,0741326839,"Företagskonto",SEK,2023-01-23,2023-01-23,2023-01-23,"Internöverföring","Överföring via internet",-1400.00,78445.42
595,83139,0741326839,"Företagskonto",SEK,2023-01-23,2023-01-23,2023-01-23,"83139741326862","Överföring via internet",-800.00,79845.42
596,83139,0741326839,"Företagskonto",SEK,2023-01-20,2023-01-20,2023-01-20,"","Pris banktjänster enligt faktura",-1212.00,80645.42
597,83139,0741326839,"Företagskonto",SEK,2023-01-18,2023-01-18,2023-01-18,"1022301180007526","Pris avisering",-10.00,81857.42
598,83139,0741326839,"Företagskonto",SEK,2023-01-18,2023-01-18,2023-01-18,"1022301180007526","Pris betalning",-1.50,81867.42
599,83139,0741326839,"Företagskonto",SEK,2023-01-18,2023-01-18,2023-01-19,"1022301180007526","Europabetalning",525.00,81868.92
600,83139,0741326839,"Företagskonto",SEK,2023-01-17,2023-01-17,2023-01-18,"6428437","Bankgiro inbetalning",1606.00,81343.92
601,83139,0741326839,"Företagskonto",SEK,2023-01-17,2023-01-17,2023-01-17,"Adobe creative c","Bg-bet. via internet",-6243.00,79737.92
602,83139,0741326839,"Företagskonto",SEK,2023-01-17,2023-01-16,2023-01-16,"Internöverföring","Överföring via internet",-20000.00,85980.92
603,83139,0741326839,"Företagskonto",SEK,2023-01-16,2023-01-16,2023-01-17,"6428437","Bankgiro inbetalning",220.00,105980.92
604,83139,0741326839,"Företagskonto",SEK,2023-01-13,2023-01-13,2023-01-13,"LUNDS KOMMUN","Bg-bet. via internet",-1200.00,105760.92
605,83139,0741326839,"Företagskonto",SEK,2023-01-12,2023-01-12,2023-01-13,"6428437","Bankgiro inbetalning",36000.00,106960.92
606,83139,0741326839,"Företagskonto",SEK,2023-01-12,2023-01-12,2023-01-12,"FETSM 1","Bg-bet. via internet",-1400.00,70960.92
607,83139,0741326839,"Företagskonto",SEK,2023-01-12,2023-01-11,2023-01-11,"Tillstånd Farad","Bg-bet. via internet",-1400.00,72360.92
608,83139,0741326839,"Företagskonto",SEK,2023-01-12,2023-01-11,2023-01-11,"Tillstånd Farad","Bg-bet. via internet",-1400.00,73760.92
609,83139,0741326839,"Företagskonto",SEK,2023-01-11,2023-01-11,2023-01-12,"6428437","Bankgiro inbetalning",1180.00,75160.92
610,83139,0741326839,"Företagskonto",SEK,2023-01-11,2023-01-11,2023-01-11,"Hyra gasque SING","Bg-bet. via internet",-16110.00,73980.92
611,83139,0741326839,"Företagskonto",SEK,2023-01-11,2023-01-11,2023-01-11,"E-tryckeriet","Bg-bet. via internet",-5947.00,90090.92
612,83139,0741326839,"Företagskonto",SEK,2023-01-11,2023-01-11,2023-01-11,"Hyra Cornelis St","Bg-bet. via internet",-3800.00,96037.92
613,83139,0741326839,"Företagskonto",SEK,2023-01-11,2023-01-11,2023-01-11,"Hyra Nollegasque","Bg-bet. via internet",-34290.00,99837.92
614,83139,0741326839,"Företagskonto",SEK,2023-01-11,2023-01-11,2023-01-11,"Hyra Gasque Jubi","Bg-bet. via internet",-24595.00,134127.92
615,83139,0741326839,"Företagskonto",SEK,2023-01-11,2023-01-11,2023-01-11,"Intervjumat","Överföring via internet",-85.00,158722.92
616,83139,0741326839,"Företagskonto",SEK,2023-01-11,2023-01-11,2023-01-11,"Bokföringsmat","Överföring via internet",-170.00,158807.92
617,83139,0741326839,"Företagskonto",SEK,2023-01-11,2023-01-11,2023-01-11,"Internöverföring","Överföring via internet",80000.00,158977.92
618,83139,0741326839,"Företagskonto",SEK,2023-01-11,2023-01-11,2023-01-11,"Ledningstack","Överföring via internet",-3457.70,78977.92
619,83139,0741326839,"Företagskonto",SEK,2023-01-11,2023-01-11,2023-01-11,"Bokföringsmat","Överföring via internet",-85.00,82435.62
620,83139,0741326839,"Företagskonto",SEK,2023-01-11,2023-01-11,2023-01-11,"Bokföringsmat","Överföring via internet",-85.00,82520.62
621,83139,0741326839,"Företagskonto",SEK,2023-01-04,2023-01-04,2023-01-05,"6428437","Bankgiro inbetalning",150.00,82605.62
622,83139,0741326839,"Företagskonto",SEK,2023-01-03,2023-01-03,2023-01-04,"6428437","Bankgiro inbetalning",2000.00,82455.62
623,83139,0741326839,"Företagskonto",SEK,2023-01-02,2023-01-02,2023-01-03,"6428437","Bankgiro inbetalning",47504.00,80455.62
